Completed Date;Reference;Paid Out (CHF);Paid In (CHF);Exchange Out;Exchange In; Balance (CHF);Category
March 5;Cash at Cs Nyon_5;200.00;;;; 2'010.09;cash
March 5;Caf? Ex Machina S?rl;6.00;;;; 2'210.09;restaurants
March 5;Caf? Ex Machina S?rl;9.50;;;; 2'216.09;restaurants
March 5;Pharmacie-Parf. Sunsto;21.80;;;; 2'225.59;health
March 5;Manor Ag;55.75;;;; 2'247.39;groceries
March 5;Manor Ag;15.00;;;; 2'303.14;shopping
March 5;Manor Ag;24.90;;;; 2'318.14;shopping
March 4;Paypal;32.35;;GBP 24.38;; 2'343.04;services
March 4;H  M;141.95;;;; 2'375.39;shopping
March 1;L'ambroisie;20.85;;;; 2'517.34;groceries
February 25;Paypal *gnabbi;137.84;;GBP 104.98;; 2'538.19;shopping
February 22;Pharmacie-parf. Sunsto;15.70;;;; 2'676.03;health
February 20;Pharmacie-parf. Sunsto;44.60;;;; 2'691.73;health
February 15;Manor Ag;48.20;;;; 2'736.33;shopping
February 15;Coop Supermarché Signy;251.40;;;; 2'784.53;groceries
February 15;C?t? Est Sa;72.90;;;; 3'035.93;shopping
February 14;McDonald's;3.50;;;; 3'108.83;restaurants
February 14;Caf? Ex Machina S?rl;5.90;;;; 3'112.33;restaurants
February 14;Caf? Ex Machina S?rl;4.30;;;; 3'118.23;restaurants
February 13;Boréal Coffee Shop;23.70;;;; 3'122.53;restaurants
February 13;Lionel B.;230.00;;;; 3'146.23;health
February 13;Paypal *georginayou;8.41;;GBP 6.49;; 3'376.23;shopping
February 13;Covered Parking Place Cornavin SA;3.00;;;; 3'384.64;transport
February 13;Restaurant Luigia Nyon;74.50;;;; 3'387.64;restaurants
February 13;Cashpay;199.90;;;; 3'462.14;shopping
February 13;Manor Ag;99.60;;;; 3'662.04;shopping
February 13;Manor Ag;31.40;;;; 3'761.64;shopping
February 13;Paypal;16.63;;GBP 12.84;; 3'793.04;services
February 12;Läderach;7.50;;;; 3'809.67;shopping
February 12;Paypal;43.13;;GBP 33.13;; 3'817.17;services
February 11;Paypal *vinnysimpso;12.03;;GBP 9.29;; 3'860.30;shopping
February 11;Paypal;16.72;;GBP 12.92;; 3'872.33;services
February 11;Paypal;16.66;;GBP 12.87;; 3'889.05;services
February 11;Paypal *jameshuntle;16.76;;GBP 12.95;; 3'905.71;shopping
February 11;Istanbul Grill  Mezz?;83.00;;;; 3'922.47;restaurants
February 11;Manor Ag;12.00;;;; 4'005.47;shopping
February 11;Manor Ag - Parking;15.00;;;; 4'017.47;transport
February 11;Manor Ag;20.25;;;; 4'032.47;groceries
February 11;Manor Ag;7.90;;;; 4'052.72;shopping
February 11;Manor Ag;25.00;;;; 4'060.62;shopping
February 11;Manor Ag;61.75;;;; 4'085.62;shopping
February 8;Paypal *asmallworld;47.92;;GBP 36.94;; 4'147.37;shopping
February 8;Mandarin Oriental, Geneva;70.00;;;; 4'195.29;travel
February 8;Manor Genève;27.45;;;; 4'265.29;groceries
February 8;Manor Genève;23.00;;;; 4'292.74;shopping
February 8;Zara Suisse Sàrl;218.10;;;; 4'315.74;shopping
February 8;Manor Genève;130.45;;;; 4'533.84;groceries
February 7;Restaurant Luigia Nyon;72.00;;;; 4'664.29;restaurants
February 5;Migros;81.20;;;; 4'736.29;groceries
February 5;Cafe Du Chateau;50.00;;;; 4'817.49;restaurants
February 5;L'ambroisie;24.90;;;; 4'867.49;groceries
February 4;From Martin Tengelin;; 4'000.00;;; 4'892.39;transfers
February 4;Hotel De La Paix ;144.50;;;; 892.39;travel
February 4;Paypal;73.99;;GBP 56.95;; 1'036.89;services
February 4;Paypal *tabickmore;299.57;;GBP 230.61;; 1'110.88;shopping
February 4;Paypal *okerimo;92.75;;GBP 71.44;; 1'410.45;shopping
February 4;SBB;4.50;;;; 1'503.20;transport
February 4;SBB;4.50;;;; 1'507.70;transport
February 1;Eurest ;12.50;;;; 1'512.20;restaurants
January 30;McDonald's;10.00;;;; 1'524.70;restaurants
January 30;Brasserie De Rive;51.70;;;; 1'534.70;restaurants
January 30;Caf? Ex Machina S?rl;9.00;;;; 1'586.40;restaurants
January 30;Paypal *sanchostore;30.12;;GBP 23.08;; 1'595.40;shopping
January 29;Pharmacie-parf. Sunsto;17.50;;;; 1'625.52;health
January 29;Jayland;17.50;;;; 1'643.02;entertainment
January 29;H  M;200.55;;;; 1'660.52;shopping
January 29;Caf? Ex Machina S?rl;8.00;;;; 1'861.07;restaurants
January 29;Manor Ag;17.90;;;; 1'869.07;shopping
January 29;Manor Ag;30.70;;;; 1'886.97;shopping
January 29;Manor Ag;30.65;;;; 1'917.67;shopping
January 29;Paypal;39.60;;GBP 30.32;; 1'948.32;shopping
January 28;Sumup  *pb Pain Et Bri;9.60;;;; 1'987.92;restaurants
January 28;Sumup  *pb Pain Et Bri;23.80;;;; 1'997.52;restaurants
January 28;Coop Pronto Nyon;63.25;;;; 2'021.32;transport
January 28;Cash at Nursery Centre Croquelune;230.60;;;; 2'084.57;cash
January 28;Castel Bowling;42.00;;;; 2'315.17;entertainment
January 28;Espace Bebe;571.77;;EUR 504.96;; 2'357.17;shopping
January 25;Caf? Ex Machina S?rl;8.50;;;; 2'928.94;restaurants
January 25;Caf? Ex Machina S?rl;5.00;;;; 2'937.44;restaurants
January 25;Pharmacie-parf. Sunsto;52.25;;;; 2'942.44;health
January 24;Caf? Ex Machina S?rl;13.50;;;; 2'994.69;restaurants
January 23;Paypal *laredoutesu;127.28;;GBP 99.33;; 3'008.19;shopping
January 22;Lidl 124 - Gland;100.25;;;; 3'135.47;groceries
January 22;IKEA;65.80;;;; 3'235.72;utilities
January 14;Paypal;171.92;;GBP 135.23;; 3'301.52;shopping
January 11;Manor Ag;26.30;;;; 3'473.44;shopping
January 11;Manor Ag;129.60;;;; 3'499.74;shopping
January 10;Pharmacie-parf. Sunsto;29.90;;;; 3'629.34;health
January 10;Caf? Ex Machina S?rl;5.00;;;; 3'659.24;restaurants
January 9;Parking du Mont-Blanc;14.00;;;; 3'664.24;services
January 9;Eurest ;13.25;;;; 3'678.24;restaurants
January 9;Coop-1530 Nyon-lev;95.55;;;; 3'691.49;groceries
January 9;Globus Gastro Gen ve;26.00;;;; 3'787.04;groceries
January 9;Kiehl's @ Globus Geneve;1'283.40;;;; 3'813.04;shopping
January 9;Kiehl's @ Globus Geneve;299.50;;;; 5'096.44;shopping
January 9;Kiehl's @ Globus Geneve;71.90;;;; 5'395.94;shopping
January 8;Coop Supermarché Verbier;67.55;;;; 5'467.84;groceries
January 8;Paypal *nova Trends;41.68;;GBP 33.01;; 5'535.39;shopping
January 7;Restaurant Le Dahu;55.00;;;; 5'577.07;restaurants
January 7;Remont es M caniques M;18.00;;;; 5'632.07;transport
January 7;Paypal;8.60;;GBP 6.89;; 5'650.07;services
January 4;Coop Supermarché Verbier;53.25;;;; 5'658.67;groceries
January 4;Restaurant Le Dahu;7.00;;;; 5'711.92;restaurants
January 4;Restaurant Le Dahu;5.00;;;; 5'718.92;restaurants
January 4;Remont es M caniques M;66.00;;;; 5'723.92;transport
January 3;From Martin Tengelin;; 5'000.00;;; 5'789.92;transfers
January 3;SOCAR Bursins;123.47;;;; 789.92;transport
January 3;Sumup  *pb Pain Et Bri;8.00;;;; 913.39;restaurants
January 2;HMSHost Sweden;8.95;;GBP 7.13;; 921.39;restaurants
January 2;World Of Toys Terminal;8.65;;SEK 78.00;; 930.34;shopping
2018 December 31;Hotel Diplomat;54.50;;SEK 493.00;; 938.99;travel
2018 December 31;Paypal;15.88;;GBP 12.63;; 993.49;services
2018 December 31;Paypal;42.62;;GBP 33.89;; 1'009.37;services
2018 December 31;H M Se0151 Taby;41.79;;SEK 378.00;; 1'051.99;shopping
2018 December 31;Rusta Teby 92;158.13;;SEK 1'430.50;; 1'093.78;utilities
2018 December 31;Room;205.47;;SEK 1'858.70;; 1'251.91;utilities
2018 December 31;Malmstensbutiken;24.16;;SEK 220.00;; 1'457.38;utilities
2018 December 31;Malmstensbutiken;131.59;;SEK 1'198.00;; 1'481.54;utilities
2018 December 31;Svenskt Tenn;13.19;;SEK 120.00;; 1'613.13;utilities
2018 December 30;To Martin Tengelin;800.00;;;; 1'626.32;transfers
2018 December 29;Uppsala Kommuns Parker;11.10;;SEK 101.00;; 2'426.32;transport
2018 December 29;Nelins Livsmedelsbutik;45.12;;SEK 412.34;; 2'437.42;groceries
2018 December 29;The Hairshop;123.68;;SEK 1'127.00;; 2'482.54;health
2018 December 28;Apoteket Centralen Exp;42.79;;SEK 387.50;; 2'606.22;health
2018 December 28;Liseberg;66.39;;SEK 599.00;; 2'649.01;restaurants
2018 December 28;Liseberg;3.88;;SEK 35.00;; 2'715.40;restaurants
2018 December 28;Le Petit;17.18;;SEK 155.00;; 2'719.28;restaurants
2018 December 28;Lust  Fargring;79.08;;SEK 714.00;; 2'736.46;shopping
2018 December 28;Tea.s I Haga;43.45;;SEK 392.00;; 2'815.54;groceries
2018 December 28;Escacito Ab;2.78;;SEK 25.00;; 2'858.99;restaurants
2018 December 27;Joutec;84.10;;;; 2'861.77;shopping
2018 December 21;Manor Ag;18.80;;;; 2'945.87;shopping
2018 December 21;Asia Market;50.00;;;; 2'964.67;groceries
2018 December 21;Caf? Ex Machina S?rl;9.50;;;; 3'014.67;restaurants
2018 December 21;Lionel B.;230.00;;;; 3'024.17;health
2018 December 19;Quincaillerie L. Micha;31.80;;;; 3'254.17;shopping
2018 December 18;Sumup arctic Juice;24.00;;;; 3'285.97;restaurants
2018 December 18;Attitude Verbier Sarl;32.00;;;; 3'309.97;shopping
2018 December 18;Attitude Verbier Sarl;131.00;;;; 3'341.97;shopping
2018 December 18;Hotair;460.80;;;; 3'472.97;shopping
2018 December 18;Caf? Ex Machina S?rl;5.00;;;; 3'933.77;restaurants
2018 December 18;Coop Supermarché Verbier;11.25;;;; 3'938.77;groceries
2018 December 17;Mc Donald's;7.20;;;; 3'950.02;restaurants
2018 December 17;Manor Ag;74.50;;;; 3'957.22;shopping
2018 December 17;Pharmacie-parf. Sunsto;39.90;;;; 4'031.72;health
2018 December 17;Sushi Haiku;16.00;;;; 4'071.62;restaurants
2018 December 17;Cash at Nursery Centre Croquelune;80.00;;;; 4'087.62;cash
2018 December 17;Migros-parking La Comb;1.00;;;; 4'167.62;transport
2018 December 17;IKEA;134.45;;;; 4'168.62;utilities
2018 December 14;Eurest ;12.70;;;; 4'303.07;restaurants
2018 December 13;Caf? Ex Machina S?rl;38.00;;;; 4'315.77;restaurants
2018 December 13;Caf? Ex Machina S?rl;12.20;;;; 4'353.77;restaurants
2018 December 11;Eurest ;13.90;;;; 4'365.97;restaurants
2018 December 10;La Galerie Du Chocolat;5.00;;;; 4'379.87;groceries
2018 December 10;Xtreme Sports;129.00;;;; 4'384.87;shopping
2018 December 10;Ski Service;39.00;;;; 4'513.87;shopping
2018 December 10;Alpimages S?rl;12.50;;;; 4'552.87;shopping
2018 December 10;Eni Lavaux Amont;135.41;;;; 4'565.37;transport
2018 December 10;Brasserie Le Bec;75.55;;;; 4'700.78;restaurants
2018 December 10;IKEA;65.65;;;; 4'776.33;utilities
2018 December 10;IKEA;309.55;;;; 4'841.98;utilities
2018 December 10;Caf? Ex Machina S?rl;4.50;;;; 5'151.53;restaurants
2018 December 10;Coop Supermarché Verbier;112.25;;;; 5'156.03;groceries
2018 December 7;Caf? Ex Machina S?rl;10.90;;;; 5'268.28;restaurants
2018 December 7;Caf? Ex Machina S?rl;5.00;;;; 5'279.18;restaurants
2018 December 7;IKEA;34.00;;;; 5'284.18;utilities
2018 December 6;SBB;7.60;;;; 5'318.18;transport
2018 December 5;Schweiz. Bundesbahn;13.30;;;; 5'325.78;transport
2018 December 4;La Galerie Du Chocolat;19.30;;;; 5'339.08;groceries
2018 December 4;Eni Yvorne-est,a9;28.15;;;; 5'358.38;transport
2018 December 4;Arts'd?cos Cr?ations S;25.00;;;; 5'386.53;utilities
2018 December 4;Coop Supermarché Verbier;34.90;;;; 5'411.53;groceries
2018 December 4;Shell Relais St-bernar;147.19;;;; 5'446.43;transport
2018 December 4;Rest Le Leman;32.00;;;; 5'593.62;restaurants
2018 December 3;To Martin Tengelin;1'000.00;;;; 5'625.62;transfers
2018 December 3;From Martin Tengelin;; 5'000.00;;; 6'625.62;transfers
2018 December 3;Caf? Ex Machina S?rl;5.00;;;; 1'625.62;restaurants
2018 December 3;Manor Ag - 315;14.90;;;; 1'630.62;shopping
2018 November 29;Caf? Ex Machina S?rl;5.00;;;; 1'645.52;restaurants
2018 November 29;La Halle Aux Chaussure;39.90;;;; 1'650.52;shopping
2018 November 29;H  M;93.95;;;; 1'690.42;shopping
2018 November 29;H  M;22.90;;;; 1'784.37;shopping
2018 November 28;Cash at Cs Nyon_5;100.00;;;; 1'807.27;cash
2018 November 27;Sushi Haiku;16.00;;;; 1'907.27;restaurants
2018 November 27;Arts'd?cos Cr?ations S;106.00;;;; 1'923.27;utilities
2018 November 27;Paypal;79.81;;GBP 62.20;; 2'029.27;shopping
2018 November 27;MANOR Nyon;45.40;;;; 2'109.08;groceries
2018 November 27;Manor Ag - 315;16.90;;;; 2'154.48;shopping
2018 November 26;La Galerie Du Chocolat;5.00;;;; 2'171.38;groceries
2018 November 26;Coop Supermarché Verbier;46.95;;;; 2'176.38;groceries
2018 November 26;Coop Supermarché Verbier;24.75;;;; 2'223.33;groceries
2018 November 26;Paypal *liuyang;17.69;;GBP 13.76;; 2'248.08;shopping
2018 November 26;Cath Kidston Ltd;125.09;;GBP 97.75;; 2'265.77;shopping
2018 November 26;Pharmacie Sun Store SA;63.10;;;; 2'390.86;health
2018 November 23;Nextory Ab;15.30;;SEK 139.00;; 2'453.96;general
2018 November 23;Dumont-blanc Au Lac;3.80;;;; 2'469.26;travel
2018 November 22;Eurest ;17.30;;;; 2'473.06;restaurants
2018 November 21;Caf? Ex Machina S?rl;5.50;;;; 2'490.36;restaurants
2018 November 20;Eurest ;16.00;;;; 2'495.86;restaurants
2018 November 19;Boulangerie Bonnin;23.50;;;; 2'511.86;groceries
2018 November 19;Orchestra;118.40;;;; 2'535.36;shopping
2018 November 19;HORNBACH Etoy;89.55;;;; 2'653.76;utilities
2018 November 19;Avec Etoy Hornbach;8.00;;;; 2'743.31;groceries
2018 November 19;Avec Etoy Hornbach;18.75;;;; 2'751.31;groceries
2018 November 19;Grand Cafe Real Sa;33.00;;;; 2'770.06;restaurants
2018 November 14;Caf? Ex Machina S?rl;9.50;;;; 2'803.06;restaurants
2018 November 13;Eurest ;14.80;;;; 2'812.56;restaurants
2018 November 12;Carrefour Restaurant;13.50;;;; 2'827.36;restaurants
2018 November 12;Yoursurprisech;39.85;;;; 2'840.86;shopping
2018 November 12;IKEA;11.00;;;; 2'880.71;utilities
2018 November 12;Sp * Neo Dolce;222.99;;GBP 170.00;; 2'891.71;health
2018 November 12;Boulangerie Bonnin;11.20;;;; 3'114.70;groceries
2018 November 12;SBB;15.20;;;; 3'125.90;transport
2018 November 12;Refund from Paypal *laredoutesu;; 85.78;;; 3'141.10;general
2018 November 9;Socar Nyon;54.60;;;; 3'055.32;transport
2018 November 9;Swiss Pneus, Cengiz ?z;190.00;;;; 3'109.92;transport
2018 November 8;Boulangerie Bonnin;12.30;;;; 3'299.92;groceries
2018 November 8;Eurest ;28.50;;;; 3'312.22;restaurants
2018 November 7;Migros;71.10;;;; 3'340.72;groceries
2018 November 6;Takinoa Nyon;5.00;;;; 3'411.82;restaurants
2018 November 6;Burger King;30.70;;;; 3'416.82;restaurants
2018 November 6;Cafe Du Chateau;65.80;;;; 3'447.52;restaurants
2018 November 5;L'ambroisie;5.20;;;; 3'513.32;groceries
2018 November 5;L'ambroisie;12.50;;;; 3'518.52;groceries
2018 November 5;Boulangerie Bonnin;6.75;;;; 3'531.02;groceries
2018 November 5;Paypal *laredoutesu;137.78;;GBP 107.02;; 3'537.77;shopping
2018 November 5;Paypal;35.20;;GBP 27.06;; 3'675.55;services
2018 November 5;Granit Sodergatan;38.58;;SEK 348.00;; 3'710.75;utilities
2018 November 5;Allt I Kok;32.69;;SEK 295.00;; 3'749.33;utilities
2018 November 5;Allt I Kok;106.17;;SEK 958.00;; 3'782.02;utilities
2018 November 3;To Martin Tengelin;1'000.00;;;; 3'888.19;transfers
2018 November 2;From Martin Tengelin;; 2'500.00;;; 4'888.19;transfers
2018 November 1;The Med Market;20.50;;;; 2'388.19;groceries
2018 November 1;Cash at Cs Nyon_5;50.00;;;; 2'408.69;cash
2018 October 30;From Martin Tengelin;; 1.00;;; 2'458.69;transfers
2018 October 30;Eurest ;10.50;;;; 2'457.69;restaurants
2018 October 15;Mc Donald's;11.90;;;; 2'468.19;restaurants
2018 October 15;Xtreme Sports;173.40;;;; 2'480.09;shopping
2018 October 15;Paypal *lizoudu28;41.03;;GBP 31.27;; 2'653.49;shopping
2018 October 15;Caf? Ex Machina S?rl;5.00;;;; 2'694.52;restaurants
2018 October 15;Eni Martigny, Combe;17.50;;;; 2'699.52;transport
2018 October 15;Lionel B.;200.00;;;; 2'717.02;health
2018 October 12;Tamoil;30.20;;;; 2'917.02;transport
2018 October 12;SOCAR Bursins;128.46;;;; 2'947.22;transport
2018 October 12;Eurest Services (Switzerland) AG;13.50;;;; 3'075.68;restaurants
2018 October 12;Paypal *laredoutesu;102.24;;GBP 78.66;; 3'089.18;shopping
2018 October 11;Eurest Services (Switzerland) AG;14.30;;;; 3'191.42;restaurants
2018 October 10;Eurest Services (Switzerland) AG;12.25;;;; 3'205.72;restaurants
2018 October 9;Eurest Services (Switzerland) AG;15.40;;;; 3'217.97;restaurants
2018 October 8;1852 Viale D'italia Sa;157.80;;;; 3'233.37;groceries
2018 October 5;Eurest Services (Switzerland) AG;3.20;;;; 3'391.17;restaurants
2018 October 5;Eurest Services (Switzerland) AG;12.50;;;; 3'394.37;restaurants
2018 October 4;Caf? Ex Machina S?rl;5.00;;;; 3'406.87;restaurants
2018 October 3;Eurest Services (Switzerland) AG;9.50;;;; 3'411.87;restaurants
2018 October 3;Paypal *ineland Ltd;10.73;;GBP 8.36;; 3'421.37;services
2018 October 2;Eurest Services (Switzerland) AG;13.85;;;; 3'432.10;restaurants
2018 October 2;Tamoil;143.60;;;; 3'445.95;transport
2018 October 2;From Martin Tengelin;; 2'500.00;;; 3'589.55;transfers
2018 October 1;Coop Tankstelle;19.45;;;; 1'089.55;transport
2018 October 1;Eurest Services (Switzerland) AG;16.00;;;; 1'109.00;restaurants
2018 October 1;Migros;137.00;;;; 1'125.00;groceries
2018 September 28;Adf Arriv es;32.70;;;; 1'262.00;shopping
2018 September 27;SBB Infrastruktur;15.20;;;; 1'294.70;transport
2018 September 26;SBB;7.60;;;; 1'309.90;transport
2018 September 26;Trendylivingdk;280.33;;DKK 1'842.39;; 1'317.50;utilities
2018 September 26;Eurest;16.00;;;; 1'597.83;restaurants
2018 September 25;Relay Gen?ve Aig G;39.40;;;; 1'613.83;shopping
2018 September 21;Eurest;9.50;;;; 1'653.23;restaurants
2018 September 20;Eurest;13.25;;;; 1'662.73;restaurants
2018 September 20;Brasserie De Rive;140.50;;;; 1'675.98;restaurants
2018 September 19;Eurest;7.70;;;; 1'816.48;restaurants
2018 September 18;Mountain-air Software;98.00;;;; 1'824.18;shopping
2018 September 18;Mountain-air Software;108.00;;;; 1'922.18;shopping
2018 September 18;Eni Lavaux Amont;128.19;;;; 2'030.18;transport
2018 September 17;Sumup  *pb Pain Et Bri;47.60;;;; 2'158.37;restaurants
2018 September 17;Coop Supermarché Verbier;2.50;;;; 2'205.97;groceries
2018 September 17;Coop Supermarché Verbier;40.95;;;; 2'208.47;groceries
2018 September 17;Restaurant La Marmotte;169.40;;;; 2'249.42;restaurants
2018 September 17;Ski Service;188.95;;GBP 148.63;; 2'418.82;shopping
2018 September 17;Paypal *cushionshop;261.15;;GBP 205.46;; 2'607.77;utilities
2018 September 14;Mc Donald's;3.90;;;; 2'868.92;restaurants
2018 September 14;Mc Donald's;4.80;;;; 2'872.82;restaurants
2018 September 14;Eurest;12.50;;;; 2'877.62;restaurants
2018 September 13;From Martin Tengelin;; 10.00;;; 2'890.12;transfers
2018 September 12;Eurest;10.55;;;; 2'880.12;restaurants
2018 September 12;Caf? Ex Machina S?rl;5.00;;;; 2'890.67;restaurants
2018 September 11;Caf? Ex Machina S?rl;5.00;;;; 2'895.67;restaurants
2018 September 10;L'ambroisie;15.10;;;; 2'900.67;groceries
2018 September 10;Au Coeur Des Saveurs;22.20;;;; 2'915.77;groceries
2018 September 10;Boulangerie Bonnin;9.60;;;; 2'937.97;groceries
2018 September 10;Boulangerie Bonnin;9.60;;;; 2'947.57;groceries
2018 September 10;Schweiz. Bundesbahn;6.50;;;; 2'957.17;transport
2018 September 10;M?bel Pfister Ag Etoy;410.80;;;; 2'963.67;utilities
2018 September 10;Ch'etoy;6.00;;;; 3'374.47;restaurants
2018 September 10;Paypal *chicsiaxian;53.06;;GBP 42.14;; 3'380.47;shopping
2018 September 10;Mc Donald's;6.60;;;; 3'433.53;restaurants
2018 September 10;Mc Donald's;13.10;;;; 3'440.13;restaurants
2018 September 10;Eurest;16.55;;;; 3'453.23;restaurants
2018 September 10;SBB;6.50;;;; 3'469.78;transport
2018 September 5;Paypal *nordish;173.33;;GBP 138.88;; 3'476.28;shopping
2018 September 4;From Martin Tengelin;; 2'500.00;;; 3'649.61;transfers
2018 September 3;Paypal *dressliving;42.61;;GBP 33.74;; 1'149.61;shopping
2018 September 3;Paypal *jameswoo190;1.90;;GBP 1.50;; 1'192.22;shopping
2018 September 3;Grand Cafe Real Sa;31.00;;;; 1'194.12;restaurants
2018 September 3;Caf? Ex Machina S?rl;9.50;;;; 1'225.12;restaurants
2018 August 31;Eurest;14.20;;;; 1'234.62;restaurants
2018 August 30;Illums Bolighus;70.48;;DKK 459.96;; 1'248.82;utilities
2018 August 30;Eurest;14.30;;;; 1'319.30;restaurants
2018 August 29;Salads And Smoothies;15.03;;SEK 140.00;; 1'333.60;restaurants
2018 August 29;Salads And Smoothies;15.04;;SEK 140.00;; 1'348.63;restaurants
2018 August 29;Olsson 6 Gerthel;23.15;;SEK 215.00;; 1'363.67;utilities
2018 August 29;Olsson 6 Gerthel;521.83;;SEK 4'845.00;; 1'386.82;utilities
2018 August 29;Copenhagen Airport;4.14;;DKK 27.00;; 1'908.65;restaurants
2018 August 29;Gebr. Heinemann Retail ApS - Terminal B Shop;41.06;;DKK 268.00;; 1'912.79;shopping
2018 August 28;Shampoo Klippotek;50.41;;SEK 468.00;; 1'953.85;health
2018 August 28;Pressbyrån;12.29;;SEK 114.00;; 2'004.26;shopping
2018 August 23;Cash at Nursery Centre Croquelune;140.00;;;; 2'016.55;cash
2018 August 23;Eurest;25.05;;;; 2'156.55;restaurants
2018 August 22;Pharmacie Nyon Fontain;24.40;;;; 2'181.60;health
2018 August 22;Eurest;23.85;;;; 2'206.00;restaurants
2018 August 22;Tamoil;158.80;;;; 2'229.85;transport
2018 August 21;Eurest;10.80;;;; 2'388.65;restaurants
2018 August 21;Noville;17.90;;;; 2'399.45;restaurants
2018 August 21;Mountain-air Software;74.00;;;; 2'417.35;shopping
2018 August 21;Restaurant Le Namast?;70.00;;;; 2'491.35;restaurants
2018 August 21;Leroy Merlin Thoiry;196.59;;EUR 174.05;; 2'561.35;utilities
2018 August 21;Leroy Merlin Thoiry;30.62;;EUR 27.10;; 2'757.94;utilities
2018 August 20;Sushi Haiku Sa;32.00;;;; 2'788.56;restaurants
2018 August 20;Caf? Ex Machina S?rl;13.50;;;; 2'820.56;restaurants
2018 August 19;Eurest;8.60;;;; 2'834.06;restaurants
2018 August 19;D?li'sen;43.90;;;; 2'842.66;restaurants
2018 August 18;Autost Milano Ghisolfa;29.15;;EUR 25.50;; 2'886.56;transport
2018 August 18;Autost Genova Ovest;12.16;;EUR 10.60;; 2'915.71;transport
2018 August 18;H  M;7.99;;EUR 6.99;; 2'927.87;shopping
2018 August 18;H  M;31.99;;EUR 27.99;; 2'935.86;shopping
2018 August 18;H  M;108.50;;EUR 94.93;; 2'967.85;shopping
2018 August 18;Autogrill 0017;5.95;;EUR 5.20;; 3'076.35;restaurants
2018 August 18;Autogrill 0017;11.42;;EUR 9.99;; 3'082.30;restaurants
2018 August 18;Coin 05530;74.75;;EUR 65.40;; 3'093.72;shopping
2018 August 14;From Martin Tengelin;; 2'500.00;;; 3'168.47;transfers
2018 August 13;To Martin Tengelin;350.00;;;; 668.47;transfers
2018 August 13;Fuli' Fula' Di Sigalin;20.17;;EUR 17.50;; 1'018.47;shopping
2018 August 13;Fuli' Fula' Di Sigalin;34.00;;EUR 29.50;; 1'038.64;shopping
2018 August 13;Porto Antico Di Genova;15.91;;EUR 14.00;; 1'072.64;general
2018 August 13;Excelsior Palace Hotel;122.23;;EUR 106.20;; 1'088.55;travel
2018 August 13;Mangini;252.45;;EUR 219.00;; 1'210.78;shopping
2018 August 10;Pattu';63.05;;EUR 55.00;; 1'463.23;health
2018 August 10;Farmacia Internazional;216.05;;EUR 188.49;; 1'526.28;health
2018 August 8;Autogrill 0064;7.62;;EUR 6.60;; 1'742.33;restaurants
2018 August 8;Autogrill 0064;22.37;;EUR 19.39;; 1'749.95;restaurants
2018 August 8;Autogrill 0064;10.96;;EUR 9.50;; 1'772.32;restaurants
2018 August 8;La Carburanti S R L;154.22;;EUR 133.70;; 1'783.28;shopping
2018 August 8;McDonald's;36.90;;;; 1'937.50;restaurants
2018 August 8;Aosta -m.bianc-rapallo;44.88;;EUR 38.90;; 1'974.40;transport
2018 August 7;Park Hotel Suiss;17.29;;EUR 15.00;; 2'019.28;travel
2018 August 7;Park Hotel Suiss;48.69;;EUR 42.30;; 2'036.57;travel
2018 August 7;Mt Blanc Ca2auto;10.31;;EUR 8.90;; 2'085.26;general
2018 August 7;Restaurant Le Cap-Horn;41.46;;EUR 35.80;; 2'095.57;restaurants
2018 August 7;Park Hotel Suiss;155.10;;EUR 133.95;; 2'137.03;travel
2018 August 6;Shell Bonneville;83.57;;EUR 72.21;; 2'292.13;transport
2018 August 6;Casino Shop;52.95;;EUR 45.73;; 2'375.70;groceries
2018 August 6;Pharmacie des Alpes;4.52;;EUR 3.90;; 2'428.65;health
2018 August 6;Beau-Rivage Palace;34.00;;;; 2'433.17;travel
2018 August 6;Paypal;38.13;;GBP 29.33;; 2'467.17;health
2018 August 4;From Martin Tengelin;; 2'500.00;;; 2'505.30;transfers
2018 July 31;Ville De Venise;23.35;;EUR 20.00;; 5.30;utilities
2018 July 31;Cash at Br Geneve_2;40.00;;;; 28.65;cash
2018 July 31;Starbucks;4.20;;;; 68.65;restaurants
2018 July 31;Franz Carl Weber;14.95;;;; 72.85;shopping
2018 July 31;Chaussures Payot;64.20;;EUR 55.00;; 87.80;shopping
2018 July 31;Superdry;105.00;;EUR 89.95;; 152.00;shopping
2018 July 31;Restaurant Le Cap-Horn;87.67;;EUR 75.10;; 257.00;restaurants
2018 July 31;Les Enflammes;33.16;;EUR 28.40;; 344.67;utilities
2018 July 31;Fresh'air;156.28;;EUR 133.90;; 377.83;utilities
2018 July 31;Cheverny;23.93;;EUR 20.50;; 534.11;utilities
2018 July 30;L'ambroisie;18.90;;;; 558.04;groceries
2018 July 30;Boulangerie Bonnin;11.10;;;; 576.94;groceries
2018 July 30;Petit Casino;16.37;;EUR 14.02;; 588.04;groceries
2018 July 30;Cocktail Abf;42.49;;EUR 36.40;; 604.41;utilities
2018 July 30;Ste Cocktail;19.50;;EUR 16.70;; 646.90;utilities
2018 July 30;Blue Ink;52.52;;EUR 45.00;; 666.40;shopping
2018 July 30;H  M;21.95;;;; 718.92;shopping
2018 July 30;Caf? Ex Machina S?rl;15.30;;;; 740.87;restaurants
2018 July 30;Caf? Ex Machina S?rl;9.50;;;; 756.17;restaurants
2018 July 30;Service Des Sports-vil;9.00;;;; 765.67;entertainment
2018 July 30;Shark's Multi Services;14.50;;;; 774.67;services
2018 July 30;Restaurant De La Pisci;5.60;;;; 789.17;travel
2018 July 30;Restaurant De La Pisci;12.00;;;; 794.77;travel
2018 July 30;Piscine De Colovray;7.00;;;; 806.77;shopping
2018 July 30;Pharmacie-parf. Sunsto;4.80;;;; 813.77;health
2018 July 30;Manor Ag - 315;19.95;;;; 818.57;shopping
2018 July 29;To Martin Tengelin;300.00;;;; 838.52;transfers
2018 July 27;Cash at Nursery Centre Croquelune;20.00;;;; 1'138.52;cash
2018 July 27;Asia Market;57.80;;;; 1'158.52;groceries
2018 July 26;Service Des Sports-vil;9.00;;;; 1'216.32;entertainment
2018 July 25;Restaurant De La Pisci;33.00;;;; 1'225.32;travel
2018 July 24;From Martin Tengelin;; 1'000.00;;; 1'258.32;transfers
2018 July 24;Pharmacie Amavita Cort;37.90;;;; 258.32;health
2018 July 24;Flowlab S?rl;18.50;;;; 296.22;health
2018 July 24;Paypal;20.82;;GBP 15.87;; 314.72;health
2018 July 23;Pharmacie-parf. Sunsto;18.75;;;; 335.54;health
2018 July 23;L'ambroisie;21.80;;;; 354.29;groceries
2018 July 23;Boulangerie Bonnin;9.30;;;; 376.09;groceries
2018 July 23;Parking du Mont-Blanc;5.00;;;; 385.39;services
2018 July 23;Restaurant de Colovray;28.00;;;; 390.39;restaurants
2018 July 21;To Martin Tengelin;300.00;;;; 418.39;transfers
2018 July 20;Kiehl's @ Globus Geneve;46.00;;;; 718.39;shopping
2018 July 20;Kiehl's @ Globus Geneve;78.20;;;; 764.39;shopping
2018 July 20;Kiehl's @ Globus Geneve;119.40;;;; 842.59;shopping
2018 July 20;Kempinski;50.00;;;; 961.99;travel
2018 July 19;MANOR Nyon;17.90;;;; 1'011.99;groceries
2018 July 19;Manor Ag - 315;56.95;;;; 1'029.89;shopping
2018 July 19;Mypos  *takinoa Nyon;19.90;;;; 1'086.84;restaurants
2018 July 18;Caf? Ex Machina S?rl;28.50;;;; 1'106.74;restaurants
2018 July 17;Cash at Nursery Centre Croquelune;110.04;;;; 1'135.24;cash
2018 July 17;Kiehl's @ Globus Geneve;39.00;;;; 1'245.28;shopping
2018 July 17;MANOR Nyon;50.35;;;; 1'284.28;groceries
2018 July 16;Gelateria Leonardo;20.00;;;; 1'334.63;restaurants
2018 July 16;Leroy Merlin;154.50;;EUR 131.95;; 1'354.63;utilities
2018 July 16;H  M;133.60;;;; 1'509.13;shopping
2018 July 16;Caf? Ex Machina S?rl;10.00;;;; 1'642.73;restaurants
2018 July 16;Pharmacie-parf. Sunsto;88.75;;;; 1'652.73;health
2018 July 16;Paypal;22.78;;GBP 17.24;; 1'741.48;health
2018 July 13;L'ambroisie;14.30;;;; 1'764.26;groceries
2018 July 13;La Plage De Nyon;71.60;;;; 1'778.56;restaurants
2018 July 12;L'ambroisie;18.10;;;; 1'850.16;groceries
2018 July 10;Eurest;13.70;;;; 1'868.26;restaurants
2018 July 10;Kiosque De Bovernier;38.00;;;; 1'881.96;shopping
2018 July 9;Quincaillerie L. Micha;15.70;;;; 1'919.96;shopping
2018 July 9;W Verbier  Residences;4.00;;;; 1'935.66;travel
2018 July 9;Mountain-air Software;49.00;;;; 1'939.66;shopping
2018 July 9;Hotair;19.80;;;; 1'988.66;shopping
2018 July 9;Coop-1281 Verbier;42.00;;;; 2'008.46;groceries
2018 July 9;Remont es M caniques M;33.00;;;; 2'050.46;transport
2018 July 9;Mountain-air Software;227.00;;;; 2'083.46;shopping
2018 July 9;W Verbier  Residences;48.00;;;; 2'310.46;travel
2018 July 9;HORNBACH Etoy;6.25;;;; 2'358.46;utilities
2018 July 9;HORNBACH Etoy;109.25;;;; 2'364.71;utilities
2018 July 6;Eurest;11.50;;;; 2'473.96;restaurants
2018 July 5;Coop-1530 Nyon-lev;194.25;;;; 2'485.46;groceries
2018 July 5;Eurest;4.85;;;; 2'679.71;restaurants
2018 July 5;Eurest;10.10;;;; 2'684.56;restaurants
2018 July 4;From Martin Tengelin;; 2'500.00;;; 2'694.66;transfers
2018 July 4;Eurest;12.90;;;; 194.66;restaurants
2018 July 3;Eurest;16.65;;;; 207.56;restaurants
2018 July 3;Manor Ag - 315;68.60;;;; 224.21;shopping
2018 July 3;La Plage De Nyon;71.60;;;; 292.81;restaurants
2018 July 2;Mc Donald's;20.70;;;; 364.41;restaurants
2018 July 2;Boulangerie Bonnin;15.10;;;; 385.11;groceries
2018 July 2;Bosphore-resto;25.80;;;; 400.21;restaurants
2018 July 2;Saint James Lo Du Lac;80.00;;;; 426.01;shopping
2018 July 2;MANOR Nyon;29.60;;;; 506.01;shopping
2018 June 29;Coop Pronto Nyon;101.85;;;; 535.61;transport
2018 June 29;Caf? Ex Machina S?rl;9.80;;;; 637.46;restaurants
2018 June 29;Eurest;1.90;;;; 647.26;restaurants
2018 June 29;Eurest;12.50;;;; 649.16;restaurants
2018 June 28;Sushi Haiku Sa;15.00;;;; 661.66;restaurants
2018 June 28;Manor Ag - 315;22.30;;;; 676.66;shopping
2018 June 27;Schweiz. Bundesbahn;9.00;;;; 698.96;transport
2018 June 27;Eurest;10.50;;;; 707.96;restaurants
2018 June 26;To Martin Tengelin;600.00;;;; 718.46;transfers
2018 June 26;Naf Naf Suisse Sa Nyon;293.40;;;; 1'318.46;shopping
2018 June 26;Caf? Ex Machina S?rl;9.00;;;; 1'611.86;restaurants
2018 June 26;Socar Nyon;19.50;;;; 1'620.86;transport
2018 June 26;Manor Ag - 315;13.00;;;; 1'640.36;shopping
2018 June 26;Manor Ag - 315;69.00;;;; 1'653.36;groceries
2018 June 25;Intermarche;48.16;;EUR 41.54;; 1'722.36;groceries
2018 June 25;Atac;1.73;;EUR 1.50;; 1'770.52;groceries
2018 June 25;Cash at Champagne-bourgogne;92.13;;EUR 80.00;; 1'772.25;cash
2018 June 25;Caf? Ex Machina S?rl;5.00;;;; 1'864.38;restaurants
2018 June 25;Caf? Ex Machina S?rl;13.00;;;; 1'869.38;restaurants
2018 June 25;H  M;7.00;;;; 1'882.38;shopping
2018 June 25;H  M;114.80;;;; 1'889.38;shopping
2018 June 22;Grand Cafe Real Sa;31.00;;;; 2'004.18;restaurants
2018 June 22;Caf? Ex Machina S?rl;9.00;;;; 2'035.18;restaurants
2018 June 22;Boutique Kooka? Nyon ;79.50;;;; 2'044.18;shopping
2018 June 22;From Martin Tengelin;; 2'000.00;;; 2'123.68;transfers
2018 June 17;From Martin Tengelin;; 100.00;;; 123.68;transfers
2018 May 11;Shark's Multi Services;16.90;;;; 23.68;services
2018 May 11;La Halle Aux Chaussure;75.00;;;; 40.58;shopping
2018 May 11;Caf? Ex Machina S?rl;7.00;;;; 115.58;restaurants
2018 May 11;Globus Gastro Gen?ve;11.00;;;; 122.58;groceries
2018 May 8;L'ambroisie;20.60;;;; 133.58;groceries
2018 May 7;Migros Fm Nyon;121.25;;;; 154.18;shopping
2018 May 7;Caves Blavignac Sa;28.00;;;; 275.43;shopping
2018 May 7;Migros Mm Porte De Nyo;64.10;;;; 303.43;groceries
2018 May 7;Cafe Du Chateau;125.10;;;; 367.53;restaurants
2018 May 7;Caf? Ex Machina S?rl;10.00;;;; 492.63;restaurants
2018 May 4;Migros Mm Porte De Nyo;135.30;;;; 502.63;groceries
2018 May 3;Eurest;9.50;;;; 637.93;restaurants
2018 May 3;Caf? Ex Machina S?rl;15.00;;;; 647.43;restaurants
2018 May 2;Grand Cafe Real Sa;101.00;;;; 662.43;restaurants
2018 May 2;Tamoil Station-service;170.75;;;; 763.43;transport
2018 May 2;Eurest;11.50;;;; 934.18;restaurants
2018 April 30;Grand Cafe Real Sa;40.00;;;; 945.68;restaurants
2018 April 29;Mc Donald's;25.70;;;; 985.68;restaurants
2018 April 27;Ddp Etoy Sa;22.50;;;; 1'011.38;restaurants
2018 April 27;Asia Market;26.10;;;; 1'033.88;groceries
2018 April 26;Migros Mm Porte De Nyo;48.80;;;; 1'059.98;groceries
2018 April 26;L Hotel De L Ange;85.00;;;; 1'108.78;travel
2018 April 26;H  M;60.80;;;; 1'193.78;shopping
2018 April 26;Eurest;10.10;;;; 1'254.58;restaurants
2018 April 25;Cafe Des Arts;94.50;;;; 1'264.68;restaurants
2018 April 23;From Martin Tengelin;; 1'000.00;;; 1'359.18;transfers
2018 April 20;Eurest;10.60;;;; 359.18;restaurants
2018 April 19;From Martin Tengelin;; 350.00;;; 369.78;transfers
2018 April 18;Eurest;8.80;;;; 19.78;restaurants
2018 April 18;Ruinettes Gestion Sa;12.00;;;; 28.58;travel
2018 April 17;Coop-2186 Signy;201.50;;;; 40.58;groceries
2018 April 17;Eurest;12.50;;;; 242.08;restaurants
2018 April 16;Restaurant Le Dahu Sa;272.50;;;; 254.58;restaurants
2018 April 16;Hmshost Amsterdam Schi;8.07;;EUR 6.80;; 527.08;restaurants
2018 April 13;Cash at Rabo;59.32;;EUR 50.00;; 535.15;cash
2018 April 13;Migros M A?roport;17.40;;;; 594.47;groceries
2018 April 13;Kiko Schiphol;45.91;;EUR 38.70;; 611.87;health
2018 April 12;Mc Donald's;4.40;;;; 657.78;restaurants
2018 April 12;Mc Donald's;8.30;;;; 662.18;restaurants
2018 April 11;Sushi Haiku Sa;22.00;;;; 670.48;restaurants
2018 April 11;Cashpay;220.00;;;; 692.48;shopping
2018 April 11;Manor Ag - 315;79.90;;;; 912.48;shopping
2018 April 11;Hmshost Amsterdam Schi;8.32;;EUR 7.05;; 992.38;restaurants
2018 April 10;Habitas Rotterdam Bv;82.53;;EUR 69.95;; 1'000.70;utilities
2018 April 10;Lekker Vers  Gezond B;19.29;;EUR 16.35;; 1'083.23;restaurants
2018 April 10;M.s. Cosmetics Haflige;16.90;;;; 1'102.52;utilities
2018 April 9;Coop-1281 Verbier;32.65;;;; 1'119.42;groceries
2018 April 9;Eni Lavaux Amont;4.50;;;; 1'152.07;transport
2018 April 9;Restaurant Le Rouge;53.00;;;; 1'156.57;restaurants
2018 April 9;Coop-1281 Verbier;331.80;;;; 1'209.57;groceries
2018 April 9;H  M;124.75;;;; 1'541.37;shopping
2018 April 9;Shop 2111;42.45;;EUR 36.01;; 1'666.12;health
2018 April 9;Shop 118 ;47.03;;EUR 39.91;; 1'708.57;shopping
2018 April 9;Shop 7326;12.37;;EUR 10.49;; 1'755.60;entertainment
2018 April 9;Shop 4721;54.11;;EUR 45.91;; 1'767.97;shopping
2018 April 9;Business Shop;128.44;;EUR 109.00;; 1'822.08;shopping
2018 April 9;Benefit Cos Z13;31.06;;USD 32.26;; 1'950.52;health
2018 April 6;Xpresspa 313029;23.30;;USD 24.19;; 1'981.58;health
2018 April 5;Musee Oceanograp;41.39;;EUR 35.00;; 2'004.88;entertainment
2018 April 4;Restaurant Musee;22.47;;EUR 19.00;; 2'046.27;restaurants
2018 April 4;Sarl 4mn;245.56;;EUR 209.00;; 2'068.74;services
2018 April 4;Franprix;5.83;;EUR 4.95;; 2'314.30;groceries
2018 April 4;From Martin Tengelin;; 2'000.00;;; 2'320.13;transfers
2018 April 4;Andro   Co;173.87;;EUR 147.00;; 320.13;restaurants
2018 April 3;Gl Nice Massena;88.15;;EUR 75.00;; 494.00;shopping
2018 April 3;Tiger Fr101;48.31;;EUR 41.10;; 582.15;utilities
2018 April 3;Sas La Compagnie De Pr;44.88;;EUR 38.20;; 630.46;health
2018 April 3;Pharmacie La Paix;33.19;;EUR 28.20;; 675.34;health
2018 April 3;Gate Group Inflight;12.00;;;; 708.53;shopping
2018 April 3;Oscar;105.76;;EUR 89.80;; 720.53;restaurants
2018 April 3;Socar Nyon;119.50;;;; 826.29;transport
2018 March 29;Pharmacie Amavita Cort;18.30;;;; 945.79;health
2018 March 29;Eurest;9.55;;;; 964.09;restaurants
2018 March 29;Cashpay;208.04;;GBP 154.44;; 973.64;shopping
2018 March 28;Caf? Ex Machina S?rl;34.00;;;; 1'181.68;restaurants
2018 March 27;Eurest;11.90;;;; 1'215.68;restaurants
2018 March 26;Restaurant Le Rouge;36.00;;;; 1'227.58;restaurants
2018 March 26;Restaurant Le Dahu Sa;190.00;;;; 1'263.58;restaurants
2018 March 26;Remont?es M?caniques M;52.00;;;; 1'453.58;transport
2018 March 24;From Martin Tengelin;; 1'000.00;;; 1'505.58;transfers
2018 March 22;Interio Etoy;39.90;;;; 505.58;utilities
2018 March 21;From Martin Tengelin;; 500.00;;; 545.48;transfers
2018 March 19;Coop Pronto Nyon;59.73;;GBP 44.77;; 45.48;transport
2018 March 16;Wah Nam Hong;152.73;;EUR 130.65;; 105.21;groceries
2018 March 16;Schweiz. Bundesbahn;7.70;;;; 257.94;transport
2018 March 16;Citizenm Rotterdam Ope;71.06;;EUR 60.80;; 265.64;travel
2018 March 15;Street-food;10.90;;;; 336.70;restaurants
2018 March 15;Citizenm Rotterdam Ope;20.23;;EUR 17.30;; 347.60;travel
2018 March 15;Hotels.com146280353593;109.95;;;; 367.83;travel
2018 March 13;Things I Like Gmbh;139.90;;;; 477.78;utilities
2018 March 13;Arts'd?cos Cr?ations S;157.00;;;; 617.68;utilities
2018 March 12;W Verbier  Residences;22.00;;;; 774.68;travel
2018 March 12;Coop-1281 Verbier;33.25;;;; 796.68;groceries
2018 March 12;Coop-1281 Verbier;88.05;;;; 829.93;groceries
2018 March 12;Chalet De Flore;25.43;;GBP 19.19;; 917.98;travel
2018 March 12;Ikea Sa Aubonne;76.77;;;; 943.41;utilities
2018 March 12;Ikea Sa Aubonne;40.70;;;; 1'020.18;utilities
2018 March 3;Extra Revolut Card;7.00;;;; 1'060.88;general
2018 February 25;From Martin Tengelin;; 1'045.00;;; 1'067.88;transfers
2018 February 25;To Martin Tengelin;600.00;;;; 22.88;transfers
2018 February 15;Quai 23 Sarl;22.00;;;; 622.88;restaurants
2018 February 15;Tamoil Station-service;214.75;;;; 644.88;transport
2018 February 15;Eurest;11.10;;;; 859.63;restaurants
2018 February 14;Drog.-parf. Sunstore;7.65;;;; 870.73;health
2018 February 14;Eurest;11.50;;;; 878.38;restaurants
2018 February 12;Bosphore-resto;36.70;;;; 889.88;restaurants
2018 February 12;Asia Market;49.25;;;; 926.58;groceries
2018 February 12;Zebra Fashion;57.70;;;; 975.83;shopping
2018 February 12;Headphone Hub Msp-hh1;23.10;;USD 24.66;; 1'033.53;shopping
2018 February 8;Bare Escentuals #119;62.42;;USD 66.67;; 1'056.63;health
2018 February 8;Urban Outfitters 63;15.10;;USD 16.12;; 1'119.05;shopping
2018 February 8;Boutique Jf3;10.00;;;; 1'134.15;shopping
2018 February 8;Ugg;40.22;;USD 43.00;; 1'144.15;shopping
2018 February 7;Xpresspa Ams Lounge 2;78.19;;GBP 59.98;; 1'184.37;health
2018 February 7;Your Fashion Store;305.00;;;; 1'262.56;shopping
2018 February 6;Grand Cafe Real Sa;40.00;;;; 1'567.56;restaurants
2018 February 5;Shop 2441;15.60;;EUR 13.46;; 1'607.56;shopping
2018 February 3;To Martin Tengelin;500.00;;;; 1'623.16;transfers
2018 February 2;From Martin Tengelin;; 2'000.00;;; 2'123.16;transfers
2018 January 31;Dubai Life Pharmacy 11;23.86;;AED 93.55;; 123.16;health
2018 January 31;Dubai Duty Free- C2 Go;122.16;;AED 480.00;; 147.02;shopping
2018 January 30;Coop-1281 Verbier;138.80;;;; 269.18;groceries
2018 January 30;Coop-1281 Verbier;45.55;;;; 407.98;groceries
2018 January 30;Cash at Cbd Burj Arab B;76.56;;AED 300.00;; 453.53;cash
2018 January 29;Paypal;52.87;;GBP 39.79;; 530.09;shopping
2018 January 29;Au Coeur Des Saveurs;12.80;;;; 582.96;groceries
2018 January 29;Grand Cafe Real Sa;30.00;;;; 595.76;restaurants
2018 January 29;Pharmacie-parf. Sunsto;53.00;;;; 625.76;health
2018 January 29;Boutique Kooka? Nyon ;42.84;;;; 678.76;shopping
2018 January 27;From Martin Tengelin;; 500.00;;; 721.60;transfers
2018 January 26;Eurest;8.85;;;; 221.60;restaurants
2018 January 25;Wwwscandishopch;92.15;;;; 230.45;groceries
2018 January 25;Eurest;28.80;;;; 322.60;restaurants
2018 January 25;Socar Nyon;115.01;;;; 351.40;transport
2018 January 24;Grand Cafe Real Sa;45.00;;;; 466.41;restaurants
2018 January 24;Eurest;9.50;;;; 511.41;restaurants
2018 January 23;Parking Villereuse;7.00;;;; 520.91;transport
2018 January 22;Parking Du Mont-blanc;18.00;;;; 527.91;services
2018 January 22;Globus Gen?ve;28.00;;;; 545.91;shopping
2018 January 22;Globus Gen?ve;65.00;;;; 573.91;shopping
2018 January 22;Globus Gastro Gen?ve;16.00;;;; 638.91;groceries
2018 January 22;Molino Lacustre Gen?ve;120.50;;;; 654.91;restaurants
2018 January 22;Zara Suisse S?rl, Genf;179.60;;;; 775.41;shopping
2018 January 22;Zara Suisse S?rl, Genf;117.70;;;; 955.01;shopping
2018 January 22;Mc Donald's;35.70;;;; 1'072.71;restaurants
2018 January 17;Gebr Heinemann Retail;101.36;;DKK 641.00;; 1'108.41;shopping
2018 January 17;Shop 302 ;157.99;;DKK 999.00;; 1'209.77;shopping
2018 January 17;Talms;14.61;;EUR 12.40;; 1'367.76;shopping
2018 January 16;Delicious By Nordic Ai;42.27;;DKK 267.00;; 1'382.37;groceries
2018 January 15;Remont?es M?caniques L;24.00;;;; 1'424.64;transport
2018 January 15;Yaxian Trade Co.,ltd;64.76;;GBP 48.77;; 1'448.64;shopping
2018 January 15;Restaurant Le Dahu Sa;10.00;;;; 1'513.40;restaurants
2018 January 15;Restaurant Le Dahu Sa;109.00;;;; 1'523.40;restaurants
2018 January 15;Remont?es M?caniques M;76.00;;;; 1'632.40;transport
2018 January 12;Migros M A?roport;89.85;;;; 1'708.40;groceries
2018 January 12;Eurest;10.90;;;; 1'798.25;restaurants
2018 January 11;Citizenm Rotterdam Ope;3.22;;EUR 2.75;; 1'809.15;travel
2018 January 11;V.i.p Rotterdam;79.52;;EUR 68.00;; 1'812.37;restaurants
2018 January 11;Boutique Jf3;5.20;;;; 1'891.89;shopping
2018 January 10;Pharmacie Principale *;40.70;;;; 1'897.09;health
2018 January 10;Parking Rive Centre;14.00;;;; 1'937.79;transport
2018 January 10;Brooodzaak;10.21;;EUR 8.70;; 1'951.79;restaurants
2018 January 9;Starbucks Coffee;17.90;;;; 1'962.00;restaurants
2018 January 8;Sumup  *pb Pain Et Bri;10.00;;;; 1'979.90;restaurants
2018 January 8;Eurest;10.10;;;; 1'989.90;restaurants
2018 January 5;From Martin Tengelin;; 2'000.00;;; 2'000.00;transfers
2017 December 29;To Martin Tengelin;107.88;;;; 0.00;transfers
2017 December 29;Autost Savona Vado;18.24;;EUR 15.50;; 107.88;transport
2017 December 29;Supermercato Bio  Bio;25.47;;EUR 21.65;; 126.12;groceries
2017 December 28;Nuova Sidap Srl 91 936;31.22;;EUR 26.53;; 151.59;transport
2017 December 28;Nuova Sidap Srl 91 399;17.63;;EUR 14.99;; 182.81;transport
2017 December 28;Nuova Sidap Srl 91 399;43.12;;EUR 36.66;; 200.44;transport
2017 December 28;Sas C3b;350.65;;EUR 298.70;; 243.56;groceries
2017 December 28;Ville De Venise;179.30;;EUR 152.00;; 594.21;utilities
2017 December 28;Sicily;36.54;;EUR 31.10;; 773.51;restaurants
2017 December 28;Osteria Dei Sognatori;88.10;;EUR 75.00;; 810.05;restaurants
2017 December 27;Paypal *booking.com;123.09;;GBP 92.97;; 898.15;travel
2017 December 27;L Olympique;129.12;;EUR 110.00;; 1'021.24;restaurants
2017 December 27;Sherpa;33.87;;EUR 28.70;; 1'150.36;groceries
2017 December 27;Fujifilm Images;82.78;;EUR 70.50;; 1'184.23;shopping
2017 December 27;Sports Alpins;23.48;;EUR 19.90;; 1'267.01;services
2017 December 27;Reves D'hiver;62.52;;EUR 53.00;; 1'290.49;utilities
2017 December 27;Resonances Mont;19.94;;EUR 16.90;; 1'353.01;entertainment
2017 December 27;Pomare;159.80;;EUR 135.42;; 1'372.95;general
2017 December 27;Snell Sports;235.80;;EUR 199.90;; 1'532.75;shopping
2017 December 22;To Martin Tengelin;1'000.00;;;; 1'768.55;transfers
2017 December 22;Paypal;48.86;;GBP 37.01;; 2'768.55;services
2017 December 22;Paypal;37.08;;GBP 28.08;; 2'817.41;health
2017 December 20;Strandvagen 1;72.56;;SEK 620.00;; 2'854.49;restaurants
2017 December 20;Pocket Shop;67.44;;SEK 577.00;; 2'927.05;entertainment
2017 December 20;Arlanda T5 Pier A;54.25;;SEK 464.00;; 2'994.49;shopping
2017 December 19;Uber;16.09;;SEK 137.34;; 3'048.74;transport
2017 December 15;Victoria's Secret 0215;109.32;;USD 110.87;; 3'064.83;shopping
2017 December 12;Hanna Andersson-topang;19.55;;USD 19.58;; 3'174.15;shopping
2017 December 12;Hanna Andersson-topang;120.50;;USD 120.71;; 3'193.70;shopping
2017 December 12;Burkewilliams Topangar;219.61;;USD 220.00;; 3'314.20;health
2017 December 12;Paypal;5.26;;GBP 3.95;; 3'533.81;services
2017 December 12;Rite Aid Store - 5463;3.32;;USD 3.34;; 3'539.07;health
2017 December 12;Rite Aid Store - 5463;111.38;;USD 112.24;; 3'542.39;health
2017 December 11;Valley Sugar Nail 5;29.98;;USD 30.00;; 3'653.77;services
2017 December 11;Chateau Marmont Fb;14.98;;USD 15.00;; 3'683.75;restaurants
2017 December 11;The Coffee Bean;23.86;;USD 23.90;; 3'698.73;restaurants
2017 December 9;From Martin Tengelin;; 2'000.00;;; 3'722.59;transfers
2017 December 4;Hamley's Of London;61.15;;GBP 46.24;; 1'722.59;shopping
2017 December 4;Citizenmshoreditchcom;11.91;;GBP 9.00;; 1'783.74;travel
2017 December 4;In Spitalfields Li;64.80;;GBP 48.97;; 1'795.65;shopping
2017 December 4;Gap 2763;136.60;;GBP 103.24;; 1'860.45;shopping
2017 December 4;New Southern Railw;21.86;;GBP 16.60;; 1'997.05;transport
2017 December 4;Wcpc Gatwick (0042);8.04;;GBP 6.10;; 2'018.91;restaurants
2017 December 2;From Martin Tengelin;; 5.95;;; 2'026.95;transfers
2017 November 30;Top-up via transfer;; 2'000.00;;; 2'021.00;general
2017 November 21;From Martin Tengelin;; 1.00;;; 21.00;transfers
2017 November 21;Top-Up by *3521;; 20.00;;; 20.00;general
