Completed Date;Reference;Paid Out (CHF);Paid In (CHF);Exchange Out;Exchange In; Balance (CHF);Category
March 6;Green Gorilla;19.90;;;; 8'172.01;restaurants
March 5;Nespresso Boutique Gen;69.00;;;; 8'191.91;groceries
March 5;Activ Fitness Ag Gen?v;5.50;;;; 8'260.91;entertainment
March 5;La Maison Du Moulin Sa;60.00;;;; 8'266.41;shopping
March 5;Restaurant Mekong;44.00;;;; 8'326.41;restaurants
March 5;Lidl 124 - Gland;136.15;;;; 8'370.41;groceries
March 4;Jayland;15.50;;;; 8'506.56;entertainment
March 4;Grand Cafe Real Sa;116.30;;;; 8'522.06;restaurants
March 1;Bosphore-resto;9.90;;;; 8'638.36;restaurants
March 1;Brevent - Flegere (Chamonix Mont Blanc);38.87;;EUR 34.20;; 8'648.26;entertainment
March 1;Hôtel Mont-Blanc;31.80;;EUR 28.00;; 8'687.13;travel
March 1;Wing Sheng Store;33.76;;EUR 29.65;; 8'718.93;shopping
March 1;Sarl Wowo;77.20;;EUR 67.80;; 8'752.69;restaurants
March 1;Caf? Ex Machina S?rl;18.50;;;; 8'829.89;restaurants
March 1;Caf? Ex Machina S?rl;35.00;;;; 8'848.39;restaurants
March 1;Coop Pronto Nyon;45.00;;;; 8'883.39;transport
March 1;Payment from Martin Alexander Tengelin Et/ou;; 7'995.00;;; 8'928.39;general
March 1;Pharmacie Valle;80.51;;EUR 70.80;; 933.39;services
March 1;Le Faucigny;34.08;;EUR 30.00;; 1'013.90;travel
February 28;Lowi;101.92;;EUR 89.50;; 1'047.98;restaurants
February 27;Snell Sports;159.22;;EUR 139.95;; 1'149.90;shopping
February 27;Rest La Cabane;144.95;;EUR 127.50;; 1'309.12;restaurants
February 27;Airbnb * Hmxjkk3zt5;175.64;;USD 175.52;; 1'454.07;travel
February 26;EQIOM France;8.90;;EUR 7.80;; 1'629.71;transport
February 25;La Nautique;83.40;;;; 1'638.61;restaurants
February 25;Sushi Haiku;59.40;;;; 1'722.01;restaurants
February 25;Manor Ag;27.60;;;; 1'781.41;groceries
February 25;Caf? Ex Machina S?rl;21.00;;;; 1'809.01;restaurants
February 25;Grand Cafe Real Sa;60.80;;;; 1'830.01;restaurants
February 25;Boulangerie Bonnin;5.30;;;; 1'890.81;groceries
February 25;Rest Le Leman;62.30;;;; 1'896.11;restaurants
February 25;Migros;57.40;;;; 1'958.41;groceries
February 22;Sumup  *pb Pain Et Bri;8.80;;;; 2'015.81;restaurants
February 22;Paypal *birthposter;190.98;;EUR 168.30;; 2'024.61;shopping
February 21;Pharmacie-parf. Sunsto;58.70;;;; 2'215.59;health
February 21;Coop@home - 6003;236.00;;;; 2'274.29;groceries
February 20;Vitam Parc;21.70;;EUR 19.00;; 2'510.29;entertainment
February 20;Hospital de La Tour;4.00;;;; 2'531.99;health
February 20;Clinique Generale-b.;330.00;;;; 2'535.99;health
February 20;Migros M Etoy;59.95;;;; 2'865.99;groceries
February 20;Orchestra;197.75;;;; 2'925.94;shopping
February 20;Miniprix;119.50;;;; 3'123.69;transport
February 20;Pharmacie-parf. Sunsto;20.40;;;; 3'243.19;health
February 19;Manor Chavannes;49.90;;;; 3'263.59;shopping
February 19;McDonald's;22.38;;EUR 19.60;; 3'313.49;restaurants
February 19;Facebk *alzheimerssoci;25.00;;;; 3'335.87;services
February 18;Coop Pronto Nyon;22.35;;;; 3'360.87;transport
February 18;Migros;48.40;;;; 3'383.22;groceries
February 18;Controle Des Habitants;30.00;;;; 3'431.62;services
February 18;Google;2.00;;;; 3'461.62;services
February 15;Brin De Folie Fleurs;46.00;;;; 3'463.62;utilities
February 15;Coop Supermarché Signy;7.95;;;; 3'509.62;groceries
February 15;Brasserie De Rive;81.60;;;; 3'517.57;restaurants
February 15;Socar Nyon;22.45;;;; 3'599.17;transport
February 14;Caf? Ex Machina S?rl;13.00;;;; 3'621.62;restaurants
February 13;Ochsner Sport;3.20;;;; 3'634.62;shopping
February 13;Globus Gastro Gen ve;29.00;;;; 3'637.82;groceries
February 13;Green Gorilla Holmes P;19.90;;;; 3'666.82;restaurants
February 12;Activ Fitness Ag Gen?v;5.50;;;; 3'686.72;entertainment
February 12;Parking-relais Lausann;3.00;;;; 3'692.22;transport
February 12;Nextory Ab;10.77;;SEK 99.50;; 3'695.22;general
February 12;McDonald's;20.20;;;; 3'705.99;restaurants
February 11;Socar Nyon;110.16;;;; 3'726.19;transport
February 11;Aquatis Aquarium-vivar;18.90;;;; 3'836.35;travel
February 11;Aquatis Aquarium-vivar;69.00;;;; 3'855.25;travel
February 11;Caf? Ex Machina S?rl;16.00;;;; 3'924.25;restaurants
February 11;Caf? Ex Machina S?rl;14.00;;;; 3'940.25;restaurants
February 11;H  M;68.75;;;; 3'954.25;shopping
February 11;Drog.-parf. Sunstore;113.45;;;; 4'023.00;health
February 11;Ochsner Sport;4.80;;;; 4'136.45;shopping
February 11;Brin De Folie Fleurs;15.00;;;; 4'141.25;utilities
February 8;To Adrien De Castro;23.50;;;; 4'156.25;transfers
February 8;Activ Fitness Ag Gen?v;5.50;;;; 4'179.75;entertainment
February 8;Boucherie-espace Molar;16.50;;;; 4'185.25;groceries
February 7;The Hamburger Foundation - Paquis;25.00;;;; 4'201.75;restaurants
February 7;Restaurant coté sud;17.90;;;; 4'226.75;restaurants
February 6;Restaurant Mekong;23.00;;;; 4'244.65;restaurants
February 6;Easyjet000 Etj9t7l;144.77;;;; 4'267.65;travel
February 6;Starbucks;13.70;;;; 4'412.42;restaurants
February 6;Cash at Nursery Centre Croquelune;200.00;;;; 4'426.12;cash
February 6;Douane Gs Ferney-volta;37.25;;;; 4'626.12;services
February 5;Globus Gastro Gen ve;23.50;;;; 4'663.37;groceries
February 5;Migros;2.05;;;; 4'686.87;groceries
February 5;Migros;2.80;;;; 4'688.92;groceries
February 4;IKEA;6.50;;;; 4'691.72;utilities
February 4;IKEA;52.15;;;; 4'698.22;utilities
February 4;IKEA;305.40;;;; 4'750.37;utilities
February 4;Burger King;6.00;;;; 5'055.77;restaurants
February 4;Burger King;27.70;;;; 5'061.77;restaurants
February 4;Nike SoHo;275.41;;USD 277.32;; 5'089.47;general
February 4;Coop Supermarché Signy;24.95;;;; 5'364.88;groceries
February 4;Interdiscount-3102 Sig;84.90;;;; 5'389.83;shopping
February 4;Caf? Ex Machina S?rl;8.00;;;; 5'474.73;restaurants
February 4;To Charlotte Tengelin;4'000.00;;;; 5'482.73;transfers
February 4;Restaurant Mekong;25.00;;;; 9'482.73;restaurants
February 4;Ochsner Sport;3.20;;;; 9'507.73;shopping
February 4;Gyoza-Bar Wasabi;12.80;;;; 9'510.93;restaurants
February 4;Burger King;7.90;;;; 9'523.73;restaurants
February 4;Parking Clinique Beaul;4.00;;;; 9'531.63;transport
February 4;Coop Pronto Nyon;25.45;;;; 9'535.63;transport
February 4;Green Gorilla Holmes P;19.90;;;; 9'561.08;restaurants
February 1;Activ Fitness Ag Gen?v;5.50;;;; 9'580.98;entertainment
February 1;Migros;7.85;;;; 9'586.48;groceries
February 1;Au Berceau D'or Sa;85.00;;;; 9'594.33;shopping
February 1;Payment from Martin Alexander Tengelin Et/ou;; 7'995.00;;; 9'679.33;general
January 31;Grand Cafe Real Sa;41.00;;;; 1'684.33;restaurants
January 31;Caf? Ex Machina S?rl;21.80;;;; 1'725.33;restaurants
January 31;Interdiscount-3098 Nyo;31.90;;;; 1'747.13;shopping
January 31;Migros;89.35;;;; 1'779.03;groceries
January 29;Coop Restaurant Genève Fusterie;32.10;;;; 1'868.38;groceries
January 29;Coop 2201 Ge City Nf;6.95;;;; 1'900.48;groceries
January 29;Gyoza-Bar Wasabi;20.00;;;; 1'907.43;restaurants
January 28;Remont es M caniques L;10.00;;;; 1'927.43;transport
January 28;Mountain Air;40.50;;;; 1'937.43;shopping
January 28;Restaurant Le Dahu;70.00;;;; 1'977.93;restaurants
January 28;Restaurant Le Borsalin;30.00;;;; 2'047.93;restaurants
January 28;Coop Pronto Nyon;48.50;;;; 2'077.93;transport
January 28;Relay Le Chable Ga;6.25;;;; 2'126.43;groceries
January 28;Rest. Olympique Cuck;23.90;;;; 2'132.68;restaurants
January 28;Sumup arctic Juice;24.00;;;; 2'156.58;restaurants
January 28;Coop Supermarché Verbier;67.75;;;; 2'180.58;groceries
January 28;Mountain-air Software;164.60;;;; 2'248.33;shopping
January 25;Globus Gastro Gen ve;25.50;;;; 2'412.93;groceries
January 25;migrolino-Shop;9.80;;;; 2'438.43;groceries
January 25;Starbucks;13.70;;;; 2'448.23;restaurants
January 24;Activ Fitness Ag Gen?v;5.50;;;; 2'461.93;entertainment
January 24;Gyoza-Bar Wasabi;20.00;;;; 2'467.43;restaurants
January 24;Nespresso Boutique Gen;15.80;;;; 2'487.43;groceries
January 24;Migros;4.85;;;; 2'503.23;groceries
January 24;Green Gorilla Holmes P;19.90;;;; 2'508.08;restaurants
January 23;Coop Pronto Nyon;10.55;;;; 2'527.98;transport
January 22;H?tel Des Trois-couron;1'014.00;;;; 2'538.53;travel
January 22;Www.scandinavianstuff.;66.58;;SEK 600.00;; 3'552.53;shopping
January 22;Migros;9.45;;;; 3'619.11;groceries
January 22;Coop Restaurant Genève Fusterie;4.85;;;; 3'628.56;groceries
January 22;Nintendo of Europe;7.73;;SEK 70.00;; 3'633.41;shopping
January 22;Nintendo of Europe;8.28;;SEK 75.00;; 3'641.14;shopping
January 22;Socar Nyon;158.62;;;; 3'649.42;transport
January 21;Eurest ;11.00;;;; 3'808.04;restaurants
January 18;Otelina Swss Spa Sarl;130.00;;;; 3'819.04;health
January 18;To Adrien De Castro;23.50;;;; 3'949.04;transfers
January 18;Restaurant coté sud;18.90;;;; 3'972.54;restaurants
January 18;Gyoza-Bar Wasabi;20.00;;;; 3'991.44;restaurants
January 18;Pharmacie St-jean;36.90;;;; 4'011.44;health
January 18;Pharmacie St-jean;19.50;;;; 4'048.34;health
January 18;Caf? Ex Machina S?rl;9.00;;;; 4'067.84;restaurants
January 18;Caf? Ex Machina S?rl;10.90;;;; 4'076.84;restaurants
January 18;Lemoncha;5.50;;;; 4'087.74;groceries
January 18;Asia Market;38.95;;;; 4'093.24;groceries
January 17;Manor Ag;15.50;;;; 4'132.19;shopping
January 17;Caf? Ex Machina S?rl;8.50;;;; 4'147.69;restaurants
January 17;Coop Pronto Nyon;57.20;;;; 4'156.19;transport
January 17;Green Gorilla Holmes P;19.90;;;; 4'213.39;restaurants
January 17;Google;2.00;;;; 4'233.29;services
January 16;Migros;7.25;;;; 4'235.29;groceries
January 16;Globus Gastro Gen ve;33.00;;;; 4'242.54;groceries
January 16;Piscine Du Cossy;20.00;;;; 4'275.54;services
January 15;Grand Cafe Real Sa;48.20;;;; 4'295.54;restaurants
January 15;Coop 2201 Ge City Nf;2.60;;;; 4'343.74;groceries
January 15;Coop 2201 Ge City Nf;19.95;;;; 4'346.34;groceries
January 15;Coop Restaurant Genève Fusterie;59.25;;;; 4'366.29;groceries
January 15;Gyoza-Bar Wasabi;5.80;;;; 4'425.54;restaurants
January 15;Gyoza-Bar Wasabi;19.40;;;; 4'431.34;restaurants
January 15;Activ Fitness Ag Gen?v;5.50;;;; 4'450.74;entertainment
January 14;Sumup  *pb Pain Et Bri;28.60;;;; 4'456.24;restaurants
January 14;Sumup  *kids Fun Park;39.00;;;; 4'484.84;entertainment
January 14;IKEA;122.40;;;; 4'523.84;utilities
January 14;Coop Pronto Nyon;18.35;;;; 4'646.24;transport
January 14;Manor Ag;41.45;;;; 4'664.59;groceries
January 14;Manor Ag;33.75;;;; 4'706.04;shopping
January 14;IKEA;80.90;;;; 4'739.79;utilities
January 14;IKEA;1.50;;;; 4'820.69;utilities
January 14;Green Gorilla Holmes P;19.90;;;; 4'822.19;restaurants
January 14;Ochsner Sport;3.20;;;; 4'842.09;shopping
January 14;Luigia;87.50;;;; 4'845.29;restaurants
January 11;Boucherie-espace Molar;16.50;;;; 4'932.79;groceries
January 11;Ochsner Sport;69.90;;;; 4'949.29;shopping
January 11;Starbucks;3.90;;;; 5'019.19;restaurants
January 11;Starbucks;3.45;;;; 5'023.09;restaurants
January 11;Easyjet000    Etxmxd3;122.75;;;; 5'026.54;travel
January 9;From Adrien De Castro;; 13.50;;; 5'149.29;transfers
January 9;To Matteo Vasirani;5.00;;;; 5'135.79;transfers
January 9;Ochsner Sport;4.80;;;; 5'140.79;shopping
January 9;Parking Clinique Beaul;1.00;;;; 5'145.59;transport
January 9;Kiehl's @ Globus Geneve;148.00;;;; 5'146.59;shopping
January 9;Coop Restaurant Genève Fusterie;55.40;;;; 5'294.59;groceries
January 9;Globus Gastro Gen ve;11.60;;;; 5'349.99;groceries
January 9;Globus Gastro Gen ve;29.00;;;; 5'361.59;groceries
January 9;Migros;4.30;;;; 5'390.59;groceries
January 8;Noville;20.90;;;; 5'394.89;restaurants
January 8;Remont es M caniques L;10.00;;;; 5'415.79;transport
January 8;Carrefour Restaurant;122.70;;;; 5'425.79;restaurants
January 8;To Adrien De Castro;13.00;;;; 5'548.49;transfers
January 7;Quai 23 Sarl;20.00;;;; 5'561.49;restaurants
January 7;Starbucks;25.90;;;; 5'581.49;restaurants
January 7;Restaurant Le Dahu;24.50;;;; 5'607.39;restaurants
January 7;Coop Supermarché Verbier;42.65;;;; 5'631.89;groceries
January 4;Globus Gastro Gen ve;23.50;;;; 5'674.54;groceries
January 3;To Charlotte Tengelin;5'000.00;;;; 5'698.04;transfers
January 3;Refund from Apple Store R275;; 178.50;;; 10'698.04;shopping
January 3;Restaurant Mekong;23.00;;;; 10'519.54;restaurants
January 3;SJ Lounge Stockholm;41.56;;SEK 375.00;; 10'542.54;transport
January 3;Sumup  *pb Pain Et Bri;32.00;;;; 10'584.10;restaurants
January 3;Bosphore-resto;16.30;;;; 10'616.10;restaurants
January 3;Coop Pronto Nyon;44.80;;;; 10'632.40;transport
January 3;Restaurant Luigia Nyon;29.00;;;; 10'677.20;restaurants
January 3;Uber;8.22;;;; 10'706.20;transport
January 2;Payment from Martin Alexander Tengelin Et/ou;; 9'995.00;;; 10'714.42;general
January 2;Lavazza;67.90;;SEK 613.00;; 719.42;restaurants
2018 December 31;Netonnet Ab;340.04;;SEK 3'075.00;; 787.32;shopping
2018 December 31;Sibylla Barbyle;5.31;;SEK 48.00;; 1'127.36;restaurants
2018 December 31;Nelins Livsmedelsbutik;22.29;;SEK 201.55;; 1'132.67;groceries
2018 December 31;Taby Kopcentrum;6.64;;SEK 60.00;; 1'154.96;transport
2018 December 31;Hotel Diplomat;260.07;;SEK 2'376.00;; 1'161.60;travel
2018 December 31;Easyjetevntdmr;98.15;;;; 1'421.67;travel
2018 December 31;Rest Ciao Ciao Grande;65.92;;SEK 600.00;; 1'519.82;restaurants
2018 December 31;Grand Escalier;32.95;;SEK 300.00;; 1'585.74;restaurants
2018 December 31;Sturehof AB;180.61;;SEK 1'650.00;; 1'618.69;restaurants
2018 December 31;Stockholm Zenit;17.11;;SEK 156.00;; 1'799.30;transport
2018 December 31;Uppsala Parkerings Ab;1.10;;SEK 10.00;; 1'816.41;transport
2018 December 31;Circle K Arlandastad Eurostop;59.20;;SEK 539.80;; 1'817.51;transport
2018 December 31;Stationen;181.10;;SEK 1'650.00;; 1'876.71;restaurants
2018 December 31;From Göran Tengelin;; 25.00;;; 2'057.81;transfers
2018 December 30;From Charlotte Tengelin;; 800.00;;; 2'032.81;transfers
2018 December 29;To Göran Tengelin;1'500.00;;;; 1'232.81;transfers
2018 December 29;Apple Rue de Rive;178.50;;;; 2'732.81;shopping
2018 December 28;SJ AB;7.62;;SEK 69.00;; 2'911.31;transport
2018 December 28;Apoteket Centralen Exp;9.61;;SEK 87.00;; 2'918.93;health
2018 December 28;Liseberg;60.96;;SEK 550.00;; 2'928.54;entertainment
2018 December 28;Espresso House 146;8.73;;SEK 79.00;; 2'989.50;restaurants
2018 December 28;Liseberg;3.22;;SEK 29.00;; 2'998.23;restaurants
2018 December 28;Uber B.V.;15.76;;SEK 142.30;; 3'001.45;transport
2018 December 27;HMSHost Schiphol Airport / Exchange Avenue;31.01;;EUR 27.45;; 3'017.21;restaurants
2018 December 27;World of Delights Schiphol B.V.;64.45;;EUR 56.95;; 3'048.22;shopping
2018 December 27;Grand Cafe Real Sa;76.50;;;; 3'112.67;restaurants
2018 December 27;Amstelveen;10.00;;;; 3'189.17;travel
2018 December 27;Amstelveen;10.00;;;; 3'199.17;travel
2018 December 27;Amstelveen;10.00;;;; 3'209.17;travel
2018 December 27;Amstelveen;22.60;;;; 3'219.17;travel
2018 December 27;Aim? Pouly Sa 4858;3.00;;;; 3'241.77;groceries
2018 December 27;Aim? Pouly Sa 4858;32.80;;;; 3'244.77;groceries
2018 December 27;Pharmacie Principale Coutance;108.75;;;; 3'277.57;health
2018 December 27;Caf? Ex Machina S?rl;12.80;;;; 3'386.32;restaurants
2018 December 27;Adf Principale;66.80;;;; 3'399.12;shopping
2018 December 27;Uber;7.40;;;; 3'465.92;transport
2018 December 21;Restaurant Mekong;26.00;;;; 3'473.32;restaurants
2018 December 21;Globus Gastro Gen ve;23.50;;;; 3'499.32;groceries
2018 December 21;Fnac Rive Geneva;35.60;;;; 3'522.82;shopping
2018 December 21;Fnac Rive Geneva;55.50;;;; 3'558.42;shopping
2018 December 21;Fnac Rive Geneva;439.00;;;; 3'613.92;shopping
2018 December 21;Takinoa Fnac2;14.00;;;; 4'052.92;restaurants
2018 December 20;Udemy;14.88;;USD 14.99;; 4'066.92;services
2018 December 20;To Adrien De Castro;23.50;;;; 4'081.80;transfers
2018 December 20;Migros;14.15;;;; 4'105.30;groceries
2018 December 20;Uber;18.74;;;; 4'119.45;transport
2018 December 19;Gyoza-Bar Wasabi;18.60;;;; 4'138.19;restaurants
2018 December 19;Restaurant Luigia Nyon;90.50;;;; 4'156.79;restaurants
2018 December 19;Ochsner Sport;4.80;;;; 4'247.29;shopping
2018 December 18;Refund from L'ambroisie;; 28.00;;; 4'252.09;groceries
2018 December 18;L'ambroisie;28.00;;;; 4'224.09;groceries
2018 December 18;Restaurant Mekong;26.00;;;; 4'252.09;restaurants
2018 December 18;Activ Fitness Ag Gen?v;5.50;;;; 4'278.09;entertainment
2018 December 18;Boucherie-espace Molar;16.50;;;; 4'283.59;groceries
2018 December 18;La Gaite;12.00;;;; 4'300.09;shopping
2018 December 18;Beauty Flore;15.00;;;; 4'312.09;shopping
2018 December 18;H&M;27.70;;;; 4'327.09;shopping
2018 December 17;Boulangerie Bonnin;7.70;;;; 4'354.79;groceries
2018 December 17;Storage King;2.00;;;; 4'362.49;services
2018 December 17;Cdon Se;53.31;;SEK 488.00;; 4'364.49;shopping
2018 December 17;23andme*inc;155.75;;EUR 137.99;; 4'417.80;health
2018 December 17;Mc Donald's;24.80;;;; 4'573.55;restaurants
2018 December 17;Migros;289.60;;;; 4'598.35;groceries
2018 December 17;IKEA;29.75;;;; 4'887.95;utilities
2018 December 14;Exchanged to EUR;146.43;;EUR  130.00;; 4'917.70;general
2018 December 14;Globus Gastro Gen ve;18.00;;;; 5'064.13;groceries
2018 December 14;Parking du Mont-Blanc;7.00;;;; 5'082.13;services
2018 December 14;Nextory Ab;18.50;;SEK 169.00;; 5'089.13;general
2018 December 13;Grand Cafe Real Sa;38.00;;;; 5'107.63;restaurants
2018 December 13;Migros;13.45;;;; 5'145.63;groceries
2018 December 13;Caf? Ex Machina S?rl;8.50;;;; 5'159.08;restaurants
2018 December 12;Boucherie-espace Molar;16.50;;;; 5'167.58;groceries
2018 December 12;Ochsner Sport;3.20;;;; 5'184.08;shopping
2018 December 12;Coop Pronto Nyon;68.90;;;; 5'187.28;transport
2018 December 12;Restaurant Luigia Nyon;72.50;;;; 5'256.18;restaurants
2018 December 12;Gyoza-Bar Wasabi;5.80;;;; 5'328.68;restaurants
2018 December 12;Green Gorilla Holmes P;19.90;;;; 5'334.48;restaurants
2018 December 11;Franz Carl Weber;39.95;;;; 5'354.38;shopping
2018 December 11;Pharmacie Principale *;31.40;;;; 5'394.33;health
2018 December 11;Brezelk?nig Ag;4.00;;;; 5'425.73;groceries
2018 December 10;Rest. Olympique Cuck;20.90;;;; 5'429.73;restaurants
2018 December 10;Coop Supermarché Verbier;38.00;;;; 5'450.63;groceries
2018 December 10;Coop Supermarché Verbier;119.20;;;; 5'488.63;groceries
2018 December 10;Remont es M caniques M;30.00;;;; 5'607.83;transport
2018 December 10;Caf? Ex Machina S?rl;13.50;;;; 5'637.83;restaurants
2018 December 10;One.com;26.45;;;; 5'651.33;services
2018 December 10;Green Gorilla Holmes P;22.40;;;; 5'677.78;restaurants
2018 December 7;Bosphore-resto;12.90;;;; 5'700.18;restaurants
2018 December 7;Migros;8.95;;;; 5'713.08;groceries
2018 December 6;Grand Cafe Real Sa;48.50;;;; 5'722.03;restaurants
2018 December 6;AIG Life Insurance Company (Switzerland) Ltd;30.00;;;; 5'770.53;transport
2018 December 6;Migros;30.20;;;; 5'800.53;groceries
2018 December 5;Sushi Haiku;30.00;;;; 5'830.73;restaurants
2018 December 5;McDonald's;35.40;;;; 5'860.73;restaurants
2018 December 5;Caf? Ex Machina S?rl;9.00;;;; 5'896.13;restaurants
2018 December 5;Restaurant Luigia Nyon;132.00;;;; 5'905.13;restaurants
2018 December 5;Rstudio, Inc.;8.99;;USD 9.00;; 6'037.13;services
2018 December 5;Vivendo 1295 Geneve;60.00;;;; 6'046.12;restaurants
2018 December 5;Easyjet000 Evnvjr2;471.75;;;; 6'106.12;travel
2018 December 4;Activ Fitness Ag Gen?v;5.50;;;; 6'577.87;entertainment
2018 December 4;Migros Fm Nyon;120.00;;;; 6'583.37;shopping
2018 December 4;Restaurant du Chemin-de-Fer;80.00;;;; 6'703.37;restaurants
2018 December 4;Restaurant Vieux Verbier;105.40;;;; 6'783.37;restaurants
2018 December 4;Coop Supermarché Verbier;80.30;;;; 6'888.77;groceries
2018 December 4;migrolino-Shop;10.70;;;; 6'969.07;groceries
2018 December 4;Relay Le Chable Ga;8.45;;;; 6'979.77;groceries
2018 December 3;Apple;19.00;;;; 6'988.22;shopping
2018 December 3;From Charlotte Tengelin;; 1'000.00;;; 7'007.22;transfers
2018 December 3;To Charlotte Tengelin;5'000.00;;;; 6'007.22;transfers
2018 December 3;Elsalad S?rl;35.00;;;; 11'007.22;restaurants
2018 December 3;Kiehl's @ Globus Geneve;42.90;;;; 11'042.22;shopping
2018 December 3;Payment from Martin Alexander Tengelin Et/ou;; 9'995.00;;; 11'085.12;general
2018 December 3;McDonald’s Restaurant;6.10;;;; 1'090.12;restaurants
2018 November 30;To Adrien De Castro;24.00;;;; 1'096.22;transfers
2018 November 29;Exchanged from SEK;; 8.67;;SEK 79.00; 1'120.22;general
2018 November 29;Exchanged from USD;; 143.78;;USD 144.36; 1'111.55;general
2018 November 29;From Adrien De Castro;; 17.00;;; 967.77;transfers
2018 November 28;Globus Gastro Gen ve;25.50;;;; 950.77;groceries
2018 November 28;Uber B.V.;15.43;;;; 976.27;transport
2018 November 27;Coop Restaurant Zürich St. Annahof;13.45;;;; 991.70;groceries
2018 November 26;Restaurant du Chemin-de-Fer;109.50;;;; 1'005.15;restaurants
2018 November 26;microspot.ch;178.00;;;; 1'114.65;shopping
2018 November 26;Rest. Olympique Cuck;3.90;;;; 1'292.65;restaurants
2018 November 26;Rest. Olympique Cuck;66.80;;;; 1'296.55;restaurants
2018 November 26;Remont es M caniques M;18.00;;;; 1'363.35;transport
2018 November 26;Icebreaker_eu;79.34;;;; 1'381.35;shopping
2018 November 26;Bosphore-resto;13.90;;;; 1'460.69;restaurants
2018 November 26;Sushi Haiku;26.00;;;; 1'474.59;restaurants
2018 November 26;Microsoft;40.88;;GBP 31.99;; 1'500.59;entertainment
2018 November 26;Microsoft;40.89;;GBP 31.99;; 1'541.47;entertainment
2018 November 23;Easyjet000 Evnvjr2;194.61;;;; 1'582.36;travel
2018 November 23;Easyjet000 Evnvjr2;65.50;;;; 1'776.97;travel
2018 November 23;Globus Gastro Gen ve;25.50;;;; 1'842.47;groceries
2018 November 23;Globus Gastro Gen ve;3.50;;;; 1'867.97;groceries
2018 November 23;Facebk *unicefsverige;20.00;;;; 1'871.47;services
2018 November 22;Restaurant Mekong;42.00;;;; 1'891.47;restaurants
2018 November 21;Coophome - 6003;19.75;;;; 1'933.47;groceries
2018 November 21;Restaurant Luigia Nyon;65.00;;;; 1'953.22;restaurants
2018 November 21;Uber B.V.;9.27;;;; 2'018.22;transport
2018 November 20;Refund from www.tidningskungen.se;; 22.21;;; 2'027.49;general
2018 November 20;Boucherie-espace Molar;16.50;;;; 2'005.28;groceries
2018 November 20;Socar Nyon;130.66;;;; 2'021.78;transport
2018 November 19;Exchanged from SEK;; 143.30;;SEK 1'300.00; 2'152.44;general
2018 November 19;Www.tidningskungen.se;22.21;;SEK 199.00;; 2'009.14;shopping
2018 November 19;Parking du Mont-Blanc;23.00;;;; 2'031.35;services
2018 November 19;Coop Supermarché Verbier;112.65;;;; 2'054.35;groceries
2018 November 19;Carrefour Restaurant;90.50;;;; 2'167.00;restaurants
2018 November 19;DHL Express Switzerland Ltd;36.25;;;; 2'257.50;transport
2018 November 19;Globus Gastro Gen ve;47.00;;;; 2'293.75;groceries
2018 November 16;Google;2.00;;;; 2'340.75;services
2018 November 16;From Matteo Vasirani;; 23.50;;; 2'342.75;transfers
2018 November 16;Gyoza-Bar Wasabi;18.60;;;; 2'319.25;restaurants
2018 November 15;Genève Aéroport;22.00;;;; 2'337.85;transport
2018 November 15;Stravacom;4.00;;;; 2'359.85;entertainment
2018 November 14;Metal plan fee;160.00;;;; 2'363.85;general
2018 November 14;Plan termination refund;; 8.99;;; 2'523.85;general
2018 November 14;Globus Gastro Gen ve;18.00;;;; 2'514.86;groceries
2018 November 14;Green Gorilla Holmes P;19.90;;;; 2'532.86;restaurants
2018 November 13;Nextory Ab;15.38;;SEK 139.00;; 2'552.76;general
2018 November 13;Noville;29.80;;;; 2'568.14;restaurants
2018 November 13;Austin Article;50.05;;USD 49.72;; 2'597.94;shopping
2018 November 13;Aus 3180a Austin Artic;8.71;;USD 8.65;; 2'647.99;shopping
2018 November 12;Brasserie Le Bec;87.50;;;; 2'656.70;restaurants
2018 November 12;Albert Pougnier SA;8.85;;;; 2'744.20;groceries
2018 November 12;IKEA;87.33;;;; 2'753.05;utilities
2018 November 12;Eni Yvorne-ouest A9;120.87;;;; 2'840.38;transport
2018 November 9;Coop Online-shop;173.00;;;; 2'961.25;groceries
2018 November 8;United Web Agency;9.02;;USD 8.99;; 3'134.25;travel
2018 November 6;Satelite Gp+;28.30;;;; 3'143.27;restaurants
2018 November 5;Nike SoHo;112.77;;USD 112.58;; 3'171.57;general
2018 November 5;Rstudio, Inc.;9.07;;USD 9.00;; 3'284.34;services
2018 November 5;Rest Le Leman;74.00;;;; 3'293.41;restaurants
2018 November 5;Caf? Ex Machina S?rl;23.00;;;; 3'367.41;restaurants
2018 November 5;Asia Market;51.85;;;; 3'390.41;groceries
2018 November 5;Marcel dupont;58.50;;;; 3'442.26;restaurants
2018 November 3;From Charlotte Tengelin;; 1'000.00;;; 3'500.76;transfers
2018 November 2;To Charlotte Tengelin;2'500.00;;;; 2'500.76;transfers
2018 November 2;Payment from Martin Alexander Tengelin Et/ou;; 5'000.00;;; 5'000.76;general
2018 November 2;Paypal;22.99;;GBP 17.88;; 0.76;services
2018 October 31;From Adrien De Castro;; 13.50;;; 23.75;transfers
2018 October 31;Migros;3.10;;;; 10.25;groceries
2018 October 31;Globus Gastro Gen ve;23.50;;;; 13.35;groceries
2018 October 30;To Charlotte Tengelin;1.00;;;; 36.85;transfers
2018 October 30;Boucherie-espace Molar;16.50;;;; 37.85;groceries
2018 October 30;Brezelk nig Ag;2.00;;;; 54.35;groceries
2018 October 30;Facebk Minstoradag;10.00;;;; 56.35;services
2018 October 29;Migros Fm Nyon;258.95;;;; 66.35;shopping
2018 October 29;Migros;218.30;;;; 325.30;groceries
2018 October 29;Migros Mr Porte De Nyo;10.15;;;; 543.60;restaurants
2018 October 29;Sumup arctic Juice;33.00;;;; 553.75;restaurants
2018 October 29;Eni Martigny, Combe;121.36;;;; 586.75;transport
2018 October 29;Migros;68.55;;;; 708.11;groceries
2018 October 29;Brasserie Le Bec;45.00;;;; 776.66;restaurants
2018 October 29;Hotair;33.30;;;; 821.66;shopping
2018 October 26;Restaurant Le Borsalin;56.50;;;; 854.96;restaurants
2018 October 23;Premium plan fee;8.99;;;; 911.46;general
2018 October 16;Nextory Ab;15.48;;SEK 139.00;; 920.45;general
2018 October 15;Stravacom;4.00;;;; 935.93;entertainment
2018 October 15;Tunnel Du Grand-st-ber;31.20;;;; 939.93;transport
2018 October 15;Restaurant Vieux Verbier;66.50;;;; 971.13;restaurants
2018 October 15;Www.smartphoto.ch;23.85;;;; 1'037.63;shopping
2018 October 15;Coop Supermarché Verbier;65.10;;;; 1'061.48;groceries
2018 October 15;Coop Supermarché Verbier;47.45;;;; 1'126.58;groceries
2018 October 15;Parking du Mont-Blanc;27.00;;;; 1'174.03;services
2018 October 15;Restaurant La Marmotte;170.15;;;; 1'201.03;restaurants
2018 October 15;Globus Gastro Gen ve;23.50;;;; 1'371.18;groceries
2018 October 12;Pharmacie Nyonnaise;17.85;;;; 1'394.68;health
2018 October 12;Restaurant Wasabi;19.60;;;; 1'412.53;restaurants
2018 October 11;Vino Olio Caffe;50.00;;;; 1'432.13;restaurants
2018 October 11;Ochsner Sport;4.80;;;; 1'482.13;shopping
2018 October 10;Brezelk nig Ag;3.50;;;; 1'486.93;groceries
2018 October 10;Coop Online-shop;21.40;;;; 1'490.43;groceries
2018 October 10;Restaurant Luigia Nyon;85.00;;;; 1'511.83;restaurants
2018 October 10;Starbucks;7.80;;;; 1'596.83;restaurants
2018 October 10;Globus Gastro Gen ve;18.00;;;; 1'604.63;groceries
2018 October 10;Diesel Gen?ve Touzeau;299.00;;;; 1'622.63;shopping
2018 October 10;Parking Clinique Beaul;1.00;;;; 1'921.63;transport
2018 October 9;Sumup  *pb Pain Et Bri;18.00;;;; 1'922.63;restaurants
2018 October 9;Bosphore-resto;31.70;;;; 1'940.63;restaurants
2018 October 9;Elsalad S?rl;22.00;;;; 1'972.33;restaurants
2018 October 8;Quincaillerie L. Micha;48.50;;;; 1'994.33;shopping
2018 October 8;Patisserie-confiserie;14.60;;;; 2'042.83;groceries
2018 October 8;Brasserie Le Bec;12.00;;;; 2'057.43;restaurants
2018 October 8;Brasserie Le Bec;102.00;;;; 2'069.43;restaurants
2018 October 8;Restaurant La Marmotte;115.30;;;; 2'171.43;restaurants
2018 October 8;Klm07424179602064;122.05;;;; 2'286.73;travel
2018 October 8;Klm07424179602053;149.05;;;; 2'408.78;travel
2018 October 8;Klm07424179602042;149.05;;;; 2'557.83;travel
2018 October 8;Globus Gastro Gen ve;7.50;;;; 2'706.88;groceries
2018 October 5;Migros;6.30;;;; 2'714.38;groceries
2018 October 5;Migros;3.90;;;; 2'720.68;groceries
2018 October 5;Parking du Mont-Blanc;17.00;;;; 2'724.58;services
2018 October 5;Rstudio, Inc.;8.93;;USD 9.00;; 2'741.58;services
2018 October 4;Coop Online-shop;171.80;;;; 2'750.51;groceries
2018 October 3;Globus Gastro Gen ve;20.00;;;; 2'922.31;groceries
2018 October 3;Migros;0.65;;;; 2'942.31;groceries
2018 October 3;Restaurant Luigia Nyon;126.30;;;; 2'942.96;restaurants
2018 October 3;Uber B.V.;11.54;;;; 3'069.26;transport
2018 October 2;Le Pr?t-?-manger Corna;5.20;;;; 3'080.80;restaurants
2018 October 2;Migros;26.30;;;; 3'086.00;groceries
2018 October 2;Boucherie-espace Molar;16.50;;;; 3'112.30;groceries
2018 October 2;Restaurant Wasabi;5.80;;;; 3'128.80;restaurants
2018 October 2;To Charlotte Tengelin;2'500.00;;;; 3'134.60;transfers
2018 October 2;Payment from Martin Alexander Tengelin Et/ou;; 5'000.00;;; 5'634.60;general
2018 September 28;Vino Concept - Le Cellier;14.40;;;; 634.60;restaurants
2018 September 28;Caf? Ex Machina S?rl;8.50;;;; 649.00;restaurants
2018 September 27;H&M;13.90;;;; 657.50;shopping
2018 September 27;H&M;167.60;;;; 671.40;shopping
2018 September 27;Pharm. Populaire Cit?;35.00;;;; 839.00;health
2018 September 26;Migros;6.70;;;; 874.00;groceries
2018 September 26;Restaurant Wasabi;12.80;;;; 880.70;restaurants
2018 September 25;Grand Cafe Real Sa;19.00;;;; 893.50;restaurants
2018 September 25;Le D?barcad?re;44.80;;;; 912.50;restaurants
2018 September 24;Www.farmy.ch;134.35;;;; 957.30;restaurants
2018 September 24;Uber B.V.;11.32;;;; 1'091.65;transport
2018 September 24;SBB Infrastruktur;4.50;;;; 1'102.97;transport
2018 September 24;Uber B.V.;10.36;;;; 1'107.47;transport
2018 September 24;Ochsner Sport;4.80;;;; 1'117.83;shopping
2018 September 24;Migros;4.55;;;; 1'122.63;groceries
2018 September 24;Globus Gastro Gen ve;25.50;;;; 1'127.18;groceries
2018 September 23;Premium plan fee;8.99;;;; 1'152.68;general
2018 September 21;Restaurant Mekong;23.00;;;; 1'161.67;restaurants
2018 September 21;Globus Gastro Gen ve;29.00;;;; 1'184.67;groceries
2018 September 21;Microsoft xbox;20.36;;GBP 15.99;; 1'213.67;entertainment
2018 September 19;Migros;47.95;;;; 1'234.03;groceries
2018 September 19;Restaurant Wasabi;12.80;;;; 1'281.98;restaurants
2018 September 18;Bosphore-resto;12.90;;;; 1'294.78;restaurants
2018 September 18;Boucherie-espace Molar;18.00;;;; 1'307.68;groceries
2018 September 18;Ochsner Sport;4.80;;;; 1'325.68;shopping
2018 September 18;Relay Le Chable Ga;14.20;;;; 1'330.48;groceries
2018 September 17;Brasserie du Molard;67.00;;;; 1'344.68;restaurants
2018 September 17;Au Coeur Des Saveurs;5.60;;;; 1'411.68;groceries
2018 September 17;Restaurant Le Dahu;164.60;;;; 1'417.28;restaurants
2018 September 17;Coop Supermarché Verbier;41.35;;;; 1'581.88;groceries
2018 September 17;Parking du Mont-Blanc;8.00;;;; 1'623.23;services
2018 September 17;Parking Clinique Beaul;2.00;;;; 1'631.23;transport
2018 September 17;Pharmacie-parf. Sunsto;15.50;;;; 1'633.23;health
2018 September 17;Stravacom;4.00;;;; 1'648.73;entertainment
2018 September 14;Grand Cafe Real Sa;83.50;;;; 1'652.73;restaurants
2018 September 14;Parking du Mont-Blanc;21.00;;;; 1'736.23;services
2018 September 14;Globus Gastro Gen ve;23.50;;;; 1'757.23;groceries
2018 September 13;To Charlotte Tengelin;10.00;;;; 1'780.73;transfers
2018 September 13;Coop Online-shop;211.10;;;; 1'790.73;groceries
2018 September 12;Easyjetevntdmr;16.90;;;; 2'001.83;travel
2018 September 12;Restaurant Luigia Nyon;80.50;;;; 2'018.73;restaurants
2018 September 12;Uber B.V.;10.14;;;; 2'099.23;transport
2018 September 11;Migros;6.30;;;; 2'109.37;groceries
2018 September 11;Globus Gastro Gen ve;18.00;;;; 2'115.67;groceries
2018 September 11;Easyjet;467.46;;GBP 368.00;; 2'133.67;general
2018 September 10;Migrol Steg-gampel;8.88;;;; 2'601.13;transport
2018 September 10;Restaurant Le Dahu;43.00;;;; 2'610.01;restaurants
2018 September 10;Coop Online-shop;173.05;;;; 2'653.01;groceries
2018 September 10;Eni Martigny, Combe;14.81;;;; 2'826.06;transport
2018 September 10;Coop Ts Susten;93.15;;;; 2'840.87;transport
2018 September 7;Sumup arctic Juice;10.00;;;; 2'934.02;restaurants
2018 September 7;Sumup arctic Juice;21.00;;;; 2'944.02;restaurants
2018 September 7;Coop Supermarché Verbier;58.10;;;; 2'965.02;groceries
2018 September 7;Restaurant Le Caveau;3.70;;;; 3'023.12;restaurants
2018 September 6;Restaurant Mekong;26.00;;;; 3'026.82;restaurants
2018 September 6;Restaurant Wasabi;6.80;;;; 3'052.82;restaurants
2018 September 6;Eni Lavaux Aval;14.80;;;; 3'059.62;transport
2018 September 5;Green Gorilla Café;19.90;;;; 3'074.42;restaurants
2018 September 5;Bio C Bon Nyon Corlot;4.65;;;; 3'094.32;shopping
2018 September 5;Pizza Leggera Nyon;31.00;;;; 3'098.97;restaurants
2018 September 5;Uber B.V.;12.00;;;; 3'129.97;transport
2018 September 5;Rstudio, Inc.;8.73;;USD 9.00;; 3'141.97;services
2018 September 4;To Charlotte Tengelin;2'500.00;;;; 3'150.70;transfers
2018 September 4;Payment from Martin Alexander Tengelin Et/ou;; 5'000.00;;; 5'650.70;general
2018 September 4;Globus Gastro Gen ve;23.50;;;; 650.70;groceries
2018 September 4;Le Pet. Bouchon De Pro;74.40;;;; 674.20;restaurants
2018 September 4;Nextory Ab;17.92;;SEK 169.00;; 748.60;general
2018 September 3;Easyjet000 Evnvjr2;115.52;;;; 766.52;travel
2018 September 3;Coop Online-shop;22.95;;;; 882.04;groceries
2018 September 3;Globus Gastro Gen ve;15.00;;;; 904.99;groceries
2018 August 31;Migros;13.60;;;; 919.99;groceries
2018 August 31;Boucherie-espace Molar;16.50;;;; 933.59;groceries
2018 August 29;Mc Donald's;10.30;;;; 950.09;restaurants
2018 August 29;Restaurant Mekong;25.00;;;; 960.39;restaurants
2018 August 29;From Matteo Vasirani;; 9.00;;; 985.39;transfers
2018 August 29;To Adrien De Castro;3.00;;;; 976.39;transfers
2018 August 29;Globus Gastro Gen ve;23.50;;;; 979.39;groceries
2018 August 29;Starbucks;7.80;;;; 1'002.89;restaurants
2018 August 28;Green Gorilla Café;19.90;;;; 1'010.69;restaurants
2018 August 28;Noville;31.70;;;; 1'030.59;restaurants
2018 August 28;Starbucks;7.80;;;; 1'062.29;restaurants
2018 August 27;2dinoworld;24.00;;;; 1'070.09;entertainment
2018 August 27;Mountain-air Software;88.00;;;; 1'094.09;shopping
2018 August 27;Hotair;18.00;;;; 1'182.09;shopping
2018 August 27;Restaurant Le Dahu;106.50;;;; 1'200.09;restaurants
2018 August 27;Restaurant La Marmotte;105.10;;;; 1'306.59;restaurants
2018 August 27;Leroy Merlin Thoiry;314.73;;EUR 275.40;; 1'411.69;utilities
2018 August 27;Baillod Sa;276.00;;;; 1'726.42;shopping
2018 August 27;Coop Supermarché Verbier;28.95;;;; 2'002.42;groceries
2018 August 27;Coop Supermarché Verbier;27.20;;;; 2'031.37;groceries
2018 August 27;Eni Lavaux Aval;3.60;;;; 2'058.57;transport
2018 August 27;Sephora 270;155.27;;EUR 135.95;; 2'062.17;health
2018 August 27;Globus Gastro Gen ve;23.50;;;; 2'217.44;groceries
2018 August 27;Coop Online-shop;130.45;;;; 2'240.94;groceries
2018 August 27;La Plage De Nyon;54.00;;;; 2'371.39;restaurants
2018 August 24;Pouly Sa 4566;7.00;;;; 2'425.39;groceries
2018 August 23;Pouly Sa 4566;7.00;;;; 2'432.39;groceries
2018 August 23;Coop Online-shop;149.35;;;; 2'439.39;groceries
2018 August 23;Premium plan fee;8.99;;;; 2'588.74;general
2018 August 22;From Vacation savings;; 134.43;;; 2'597.73;transfers
2018 August 22;To Vacation savings;1.00;;;; 2'463.30;transfers
2018 August 22;Mc Donald's;18.70;;;; 2'464.30;restaurants
2018 August 22;Green Gorilla Café;19.90;;;; 2'483.00;restaurants
2018 August 22;SBB Infrastruktur;4.50;;;; 2'502.90;transport
2018 August 22;Starbucks;14.30;;;; 2'507.40;restaurants
2018 August 21;Green Gorilla Café;19.90;;;; 2'521.70;restaurants
2018 August 21;Tpg Jonction;2.00;;;; 2'541.60;transport
2018 August 21;Migros;14.15;;;; 2'543.60;groceries
2018 August 21;Manor Ag - 315;7.80;;;; 2'557.75;restaurants
2018 August 21;Noville;27.80;;;; 2'565.55;restaurants
2018 August 21;W Verbier  Residences;136.80;;;; 2'593.35;travel
2018 August 21;To Vacation savings;0.10;;;; 2'730.15;transfers
2018 August 21;Coop Supermarché Verbier;124.70;;;; 2'730.25;groceries
2018 August 21;To Vacation savings;0.70;;;; 2'854.95;transfers
2018 August 21;Mc Donald's;4.30;;;; 2'855.65;restaurants
2018 August 21;Spar;16.50;;;; 2'859.95;groceries
2018 August 20;Icebreaker_eu;93.00;;;; 2'876.45;shopping
2018 August 20;To Vacation savings;0.58;;;; 2'969.45;transfers
2018 August 20;To Vacation savings;0.30;;;; 2'970.03;transfers
2018 August 20;To Vacation savings;0.20;;;; 2'970.33;transfers
2018 August 20;To Vacation savings;0.50;;;; 2'970.53;transfers
2018 August 20;To Vacation savings;1.00;;;; 2'971.03;transfers
2018 August 20;Coop Online-shop;151.75;;;; 2'972.03;groceries
2018 August 20;Stravacom;4.00;;;; 3'123.78;entertainment
2018 August 20;To Vacation savings;0.85;;;; 3'127.78;transfers
2018 August 19;To Vacation savings;0.20;;;; 3'128.63;transfers
2018 August 19;Pouly Sa 4515;3.90;;;; 3'128.83;groceries
2018 August 18;Coop Restaurant Genève Fusterie;76.20;;;; 3'132.73;groceries
2018 August 18;Starbucks;7.80;;;; 3'208.93;restaurants
2018 August 18;Acquario Genova;80.01;;EUR 70.00;; 3'216.73;entertainment
2018 August 18;Marina Porto Antico Pa;10.06;;EUR 8.80;; 3'296.74;transport
2018 August 18;Bar Bigo;38.86;;EUR 34.00;; 3'306.80;restaurants
2018 August 18;Pharmacie Des Combins;13.20;;;; 3'345.66;health
2018 August 18;To Vacation savings;0.30;;;; 3'358.86;transfers
2018 August 18;Autogrill 0017;12.81;;EUR 11.20;; 3'359.16;restaurants
2018 August 18;Bookshop Acquario;19.43;;EUR 17.00;; 3'371.97;shopping
2018 August 17;Migros;6.30;;;; 3'391.40;groceries
2018 August 17;Tamoil Roche;126.95;;;; 3'397.70;transport
2018 August 17;To Vacation savings;0.20;;;; 3'524.65;transfers
2018 August 16;To Vacation savings;0.70;;;; 3'524.85;transfers
2018 August 16;To Vacation savings;0.50;;;; 3'525.55;transfers
2018 August 15;To Vacation savings;1.00;;;; 3'526.05;transfers
2018 August 14;2513 Olearys;44.70;;SEK 400.00;; 3'527.05;restaurants
2018 August 14;Sol Melia Italia Srl;266.18;;EUR 232.89;; 3'571.75;travel
2018 August 14;To Vacation savings;0.10;;;; 3'837.93;transfers
2018 August 14;To Vacation savings;0.10;;;; 3'838.03;transfers
2018 August 14;To Charlotte Tengelin;2'500.00;;;; 3'838.13;transfers
2018 August 14;Payment from Martin Alexander Tengelin Et/ou;; 5'000.00;;; 6'338.13;general
2018 August 13;To Vacation savings;0.26;;;; 1'338.13;transfers
2018 August 13;From Charlotte Tengelin;; 350.00;;; 1'338.39;transfers
2018 August 13;To Vacation savings;0.80;;;; 988.39;transfers
2018 August 13;To Vacation savings;0.20;;;; 989.19;transfers
2018 August 13;Www.parconazionale5ter;8.55;;EUR 7.50;; 989.39;entertainment
2018 August 13;Hotel Mediterraneo;326.36;;EUR 286.00;; 997.94;travel
2018 August 13;Il Massimo Della Focac;17.03;;EUR 15.00;; 1'324.30;restaurants
2018 August 13;Deca Ristorante;62.51;;EUR 55.00;; 1'341.33;restaurants
2018 August 13;Roma Termini;15.90;;EUR 14.00;; 1'403.84;transport
2018 August 13;Excelsior Palace Hotel;115.22;;EUR 100.00;; 1'419.74;travel
2018 August 13;Rêve Café Restaurant;95.07;;EUR 83.00;; 1'534.96;restaurants
2018 August 12;To Vacation savings;0.05;;;; 1'630.03;transfers
2018 August 12;To Vacation savings;0.70;;;; 1'630.08;transfers
2018 August 12;To Vacation savings;0.80;;;; 1'630.78;transfers
2018 August 11;To Vacation savings;0.19;;;; 1'631.58;transfers
2018 August 11;To Vacation savings;0.94;;;; 1'631.77;transfers
2018 August 11;To Vacation savings;0.14;;;; 1'632.71;transfers
2018 August 11;To Vacation savings;0.57;;;; 1'632.85;transfers
2018 August 11;To Vacation savings;0.99;;;; 1'633.42;transfers
2018 August 11;To Vacation savings;0.82;;;; 1'634.41;transfers
2018 August 10;To Vacation savings;0.49;;;; 1'635.23;transfers
2018 August 10;To Vacation savings;0.97;;;; 1'635.72;transfers
2018 August 10;To Vacation savings;0.10;;;; 1'636.69;transfers
2018 August 10;To Vacation savings;0.45;;;; 1'636.79;transfers
2018 August 10;To Vacation savings;0.33;;;; 1'637.24;transfers
2018 August 10;To Vacation savings;0.64;;;; 1'637.57;transfers
2018 August 10;To Vacation savings;1.00;;;; 1'638.21;transfers
2018 August 10;Ristorante La Cantina;140.27;;EUR 121.50;; 1'639.21;restaurants
2018 August 10;Angolo 48;149.41;;EUR 129.50;; 1'779.48;restaurants
2018 August 9;To Vacation savings;0.93;;;; 1'928.89;transfers
2018 August 9;To Vacation savings;0.78;;;; 1'929.82;transfers
2018 August 9;Cash at Deutsche Bank;115.48;;EUR 100.00;; 1'930.60;cash
2018 August 9;Brasserie De Rive;43.50;;;; 2'046.08;restaurants
2018 August 8;To Vacation savings;0.59;;;; 2'089.58;transfers
2018 August 8;To Vacation savings;0.73;;;; 2'090.17;transfers
2018 August 8;Da Emilio Ristorante P;101.08;;EUR 87.50;; 2'090.90;restaurants
2018 August 8;Wh Smith;20.54;;SEK 183.90;; 2'191.98;restaurants
2018 August 8;Starbucks Arlanda Terminal 2;6.15;;SEK 55.00;; 2'212.52;restaurants
2018 August 8;Hotels.com150772167846;342.78;;;; 2'218.67;travel
2018 August 7;To Vacation savings;0.92;;;; 2'561.45;transfers
2018 August 7;eleven;10.28;;SEK 92.00;; 2'562.37;groceries
2018 August 7;The Cloud Networks Germany GmbH;11.06;;SEK 99.00;; 2'572.65;services
2018 August 7;To Vacation savings;0.22;;;; 2'583.71;transfers
2018 August 7;To Vacation savings;0.50;;;; 2'583.93;transfers
2018 August 7;Starbucks Arlanda Terminal 2;50.14;;SEK 449.00;; 2'584.43;restaurants
2018 August 6;Circle K Nordmaling;4.95;;SEK 44.00;; 2'634.57;transport
2018 August 6;To Vacation savings;0.46;;;; 2'639.52;transfers
2018 August 6;To Vacation savings;0.86;;;; 2'639.98;transfers
2018 August 6;To Vacation savings;0.85;;;; 2'640.84;transfers
2018 August 6;To Vacation savings;0.30;;;; 2'641.69;transfers
2018 August 6;To Vacation savings;0.72;;;; 2'641.99;transfers
2018 August 6;To Vacation savings;0.94;;;; 2'642.71;transfers
2018 August 6;Facebk *leonardodicapr;20.00;;;; 2'643.65;services
2018 August 6;Rstudio, Inc.;8.95;;USD 9.00;; 2'663.65;services
2018 August 6;Nextory Ab;18.96;;SEK 169.00;; 2'672.60;general
2018 August 5;To Vacation savings;0.05;;;; 2'691.56;transfers
2018 August 4;To Vacation savings;1.00;;;; 2'691.61;transfers
2018 August 4;To Charlotte Tengelin;2'500.00;;;; 2'692.61;transfers
2018 August 4;To Vacation savings;0.04;;;; 5'192.61;transfers
2018 August 3;To Vacation savings;0.05;;;; 5'192.65;transfers
2018 August 3;Payment from Martin Alexander Tengelin Et/ou;; 5'000.00;;; 5'192.70;general
2018 July 31;Payot Pertin (Sa);4.67;;EUR 4.00;; 192.70;groceries
2018 July 31;Les Caves Chamonix;128.39;;EUR 110.00;; 197.37;restaurants
2018 July 31;Coquoz Sports;90.92;;EUR 77.90;; 325.76;shopping
2018 July 30;Iz *alpine Coffee Limi;45.52;;EUR 39.00;; 416.68;restaurants
2018 July 30;Lh. Sg;38.88;;EUR 33.30;; 462.20;entertainment
2018 July 30;Decat Chamonix;185.57;;EUR 159.00;; 501.08;utilities
2018 July 30;Dragon D Or;28.02;;EUR 24.00;; 686.65;restaurants
2018 July 30;Globus Gastro Gen ve;17.00;;;; 714.67;groceries
2018 July 30;Denner Nyon-cc La Comb;42.80;;;; 731.67;groceries
2018 July 30;Migros;119.75;;;; 774.47;groceries
2018 July 30;Coop Restaurant Genève Fusterie;18.00;;;; 894.22;groceries
2018 July 29;To Vacation savings;0.12;;;; 912.22;transfers
2018 July 29;To Vacation savings;0.08;;;; 912.34;transfers
2018 July 29;To Vacation savings;0.43;;;; 912.42;transfers
2018 July 29;From Charlotte Tengelin;; 300.00;;; 912.85;transfers
2018 July 29;To Vacation savings;0.48;;;; 612.85;transfers
2018 July 28;To Vacation savings;0.98;;;; 613.33;transfers
2018 July 28;To Vacation savings;0.33;;;; 614.31;transfers
2018 July 28;To Vacation savings;0.04;;;; 614.64;transfers
2018 July 28;To Vacation savings;0.61;;;; 614.68;transfers
2018 July 27;To Vacation savings;0.20;;;; 615.29;transfers
2018 July 27;To Vacation savings;0.25;;;; 615.49;transfers
2018 July 27;Green Gorilla Café;19.90;;;; 615.74;restaurants
2018 July 27;To Vacation savings;1.00;;;; 635.64;transfers
2018 July 27;Restaurant Wasabi;14.10;;;; 636.64;restaurants
2018 July 27;To Vacation savings;1.00;;;; 650.74;transfers
2018 July 27;Brasserie De Rive;129.60;;;; 651.74;restaurants
2018 July 26;To Vacation savings;0.90;;;; 781.34;transfers
2018 July 26;To Vacation savings;0.10;;;; 782.24;transfers
2018 July 26;Migros Fm Nyon;124.40;;;; 782.34;shopping
2018 July 26;Www.hypershop.com;99.80;;USD 100.00;; 906.74;entertainment
2018 July 25;To Vacation savings;0.40;;;; 1'006.54;transfers
2018 July 25;To Vacation savings;0.60;;;; 1'006.94;transfers
2018 July 25;Globus Gastro Gen ve;23.50;;;; 1'007.54;groceries
2018 July 24;Exchanged to BTC;100.00;;BTC  0.01210466;; 1'031.04;general
2018 July 24;To Vacation savings;0.50;;;; 1'131.04;transfers
2018 July 24;To Charlotte Tengelin;1'000.00;;;; 1'131.54;transfers
2018 July 24;Payment from Martin Alexander Tengelin Et/ou;; 2'000.00;;; 2'131.54;general
2018 July 24;Migros;31.45;;;; 131.54;groceries
2018 July 23;To Vacation savings;0.55;;;; 162.99;transfers
2018 July 23;App smartiptv;6.43;;EUR 5.49;; 163.54;utilities
2018 July 23;L'ambroisie;19.50;;;; 169.97;groceries
2018 July 23;Coop Pronto Nyon;36.00;;;; 189.47;transport
2018 July 23;Cash at Credit Suisse AG;50.00;;;; 225.47;cash
2018 July 23;Ochsner Ag;39.90;;;; 275.47;shopping
2018 July 23;Ochsner Ag;78.60;;;; 315.37;shopping
2018 July 23;Green Gorilla;19.90;;;; 393.97;restaurants
2018 July 23;H&M;7.95;;;; 413.87;shopping
2018 July 23;Restaurant Wasabi;5.80;;;; 421.82;restaurants
2018 July 22;To Vacation savings;0.57;;;; 427.62;transfers
2018 July 22;To Vacation savings;1.00;;;; 428.19;transfers
2018 July 21;To Vacation savings;0.20;;;; 429.19;transfers
2018 July 21;To Vacation savings;0.10;;;; 429.39;transfers
2018 July 21;To Vacation savings;0.40;;;; 429.49;transfers
2018 July 21;To Vacation savings;0.50;;;; 429.89;transfers
2018 July 21;From Charlotte Tengelin;; 300.00;;; 430.39;transfers
2018 July 20;To Vacation savings;0.20;;;; 130.39;transfers
2018 July 20;To Vacation savings;0.05;;;; 130.59;transfers
2018 July 20;To Vacation savings;0.10;;;; 130.64;transfers
2018 July 20;Uber;12.01;;;; 130.74;transport
2018 July 19;To Vacation savings;0.99;;;; 142.75;transfers
2018 July 19;JustGiving;52.12;;GBP 40.00;; 143.74;services
2018 July 19;Caf? Ex Machina S?rl;18.00;;;; 195.86;restaurants
2018 July 19;Restaurant Wasabi;17.70;;;; 213.86;restaurants
2018 July 18;To Vacation savings;0.30;;;; 231.56;transfers
2018 July 18;To Vacation savings;0.88;;;; 231.86;transfers
2018 July 18;Green Gorilla;19.90;;;; 232.74;restaurants
2018 July 18;To Vacation savings;1.00;;;; 252.64;transfers
2018 July 18;Parking du Mont-Blanc;5.00;;;; 253.64;services
2018 July 17;To Vacation savings;0.10;;;; 258.64;transfers
2018 July 17;Carrefour;137.95;;EUR 117.08;; 258.74;groceries
2018 July 17;To Vacation savings;1.00;;;; 396.69;transfers
2018 July 17;Restaurant Le Lacustre - près du Pont du Mont-Blanc;85.00;;;; 397.69;restaurants
2018 July 17;Brasserie De Rive;150.00;;;; 482.69;restaurants
2018 July 16;Restaurant Mekong;23.00;;;; 632.69;restaurants
2018 July 16;Gelateria Leonardo;8.70;;;; 655.69;restaurants
2018 July 16;Gelateria Leonardo;28.40;;;; 664.39;restaurants
2018 July 16;To Vacation savings;1.00;;;; 692.79;transfers
2018 July 16;Mus?e Du L?man;190.00;;;; 693.79;entertainment
2018 July 16;Lightgram.com;28.89;;USD 29.00;; 883.79;services
2018 July 16;Apple;178.50;;;; 912.68;shopping
2018 July 15;To Vacation savings;1.00;;;; 1'091.18;transfers
2018 July 15;To Vacation savings;1.00;;;; 1'092.18;transfers
2018 July 15;To Vacation savings;0.05;;;; 1'093.18;transfers
2018 July 14;To Vacation savings;1.00;;;; 1'093.23;transfers
2018 July 14;To Vacation savings;0.30;;;; 1'094.23;transfers
2018 July 14;To Vacation savings;0.60;;;; 1'094.53;transfers
2018 July 13;To Vacation savings;0.50;;;; 1'095.13;transfers
2018 July 13;To Matteo Vasirani;18.50;;;; 1'095.63;transfers
2018 July 13;Starbucks;8.50;;;; 1'114.13;restaurants
2018 July 13;Globus Gastro Gen?ve;23.50;;;; 1'122.63;groceries
2018 July 13;Coop Restaurant Genève Fusterie;5.15;;;; 1'146.13;groceries
2018 July 12;Sumup  *leonardo Compa;5.00;;;; 1'151.28;restaurants
2018 July 12;To Vacation savings;0.50;;;; 1'156.28;transfers
2018 July 12;To Vacation savings;0.50;;;; 1'156.78;transfers
2018 July 12;To Vacation savings;0.85;;;; 1'157.28;transfers
2018 July 12;ProtonMail;55.83;;EUR 48.00;; 1'158.13;shopping
2018 July 11;To Vacation savings;0.11;;;; 1'213.96;transfers
2018 July 11;To Vacation savings;0.17;;;; 1'214.07;transfers
2018 July 11;To Vacation savings;1.00;;;; 1'214.24;transfers
2018 July 11;Green Gorilla;19.90;;;; 1'215.24;restaurants
2018 July 11;Globus Gen?ve;123.20;;;; 1'235.14;shopping
2018 July 11;Restaurant Wasabi;13.60;;;; 1'358.34;restaurants
2018 July 10;To Vacation savings;0.80;;;; 1'371.94;transfers
2018 July 10;To Vacation savings;0.40;;;; 1'372.74;transfers
2018 July 10;To Vacation savings;0.10;;;; 1'373.14;transfers
2018 July 10;Migros Mmm Nyon La Com;60.60;;;; 1'373.24;groceries
2018 July 10;Globus Gastro Gen?ve;17.50;;;; 1'433.84;groceries
2018 July 10;Starbucks;5.20;;;; 1'451.34;restaurants
2018 July 10;Kkiosk Nyon;2.20;;;; 1'456.54;groceries
2018 July 9;To Vacation savings;0.80;;;; 1'458.74;transfers
2018 July 9;To Vacation savings;0.40;;;; 1'459.54;transfers
2018 July 9;To Vacation savings;0.50;;;; 1'459.94;transfers
2018 July 9;Eni Station Service;35.00;;;; 1'460.44;transport
2018 July 9;Mountain-air Software;58.50;;;; 1'495.44;shopping
2018 July 9;Restaurant Le Namast?;130.00;;;; 1'553.94;restaurants
2018 July 9;To Vacation savings;0.80;;;; 1'683.94;transfers
2018 July 9;Nu Skin België;192.01;;;; 1'684.74;health
2018 July 9;Restaurant Le Dahu;70.00;;;; 1'876.75;restaurants
2018 July 9;Easyjet;18.40;;;; 1'946.75;travel
2018 July 9;Green Gorilla;19.90;;;; 1'965.15;restaurants
2018 July 9;Migrolino Martigny;8.70;;;; 1'985.05;groceries
2018 July 9;Restaurant Wasabi;5.80;;;; 1'993.75;restaurants
2018 July 8;To Vacation savings;0.50;;;; 1'999.55;transfers
2018 July 8;To Vacation savings;1.00;;;; 2'000.05;transfers
2018 July 7;To Vacation savings;1.00;;;; 2'001.05;transfers
2018 July 7;To Vacation savings;1.00;;;; 2'002.05;transfers
2018 July 6;To Vacation savings;0.30;;;; 2'003.05;transfers
2018 July 6;To Vacation savings;0.20;;;; 2'003.35;transfers
2018 July 6;To Vacation savings;0.60;;;; 2'003.55;transfers
2018 July 6;Green Gorilla;16.90;;;; 2'004.15;restaurants
2018 July 6;Grand Cafe Real Sa;31.80;;;; 2'021.05;restaurants
2018 July 6;O'les Terrasses Du Lac;80.00;;;; 2'052.85;restaurants
2018 July 6;Easyjet;413.77;;;; 2'132.85;travel
2018 July 6;To Vacation savings;0.10;;;; 2'546.62;transfers
2018 July 6;Restaurant Wasabi;5.80;;;; 2'546.72;restaurants
2018 July 6;To Vacation savings;0.99;;;; 2'552.52;transfers
2018 July 6;Nextory Ab;1.02;;SEK 9.00;; 2'553.51;general
2018 July 5;To Vacation savings;0.98;;;; 2'554.53;transfers
2018 July 5;To Vacation savings;1.00;;;; 2'555.51;transfers
2018 July 5;To Vacation savings;0.23;;;; 2'556.51;transfers
2018 July 5;To Vacation savings;0.20;;;; 2'556.74;transfers
2018 July 5;To Vacation savings;0.10;;;; 2'556.94;transfers
2018 July 5;Refund from Manor Ag - 315;; 20.65;;; 2'557.04;general
2018 July 5;Manor Ag - 315;18.65;;;; 2'536.39;shopping
2018 July 5;Manor Ag - 315;20.65;;;; 2'555.04;shopping
2018 July 5;Migros Mmm Nyon La Com;60.35;;;; 2'575.69;groceries
2018 July 5;Uber;15.82;;;; 2'636.04;transport
2018 July 5;Rstudio, Inc.;8.94;;USD 9.00;; 2'651.86;services
2018 July 4;To Vacation savings;0.18;;;; 2'660.80;transfers
2018 July 4;To Vacation savings;0.35;;;; 2'660.98;transfers
2018 July 4;To Vacation savings;0.35;;;; 2'661.33;transfers
2018 July 4;Green Gorilla;16.90;;;; 2'661.68;restaurants
2018 July 4;To Vacation savings;0.20;;;; 2'678.58;transfers
2018 July 4;To Charlotte Tengelin;2'500.00;;;; 2'678.78;transfers
2018 July 4;To Vacation savings;0.65;;;; 5'178.78;transfers
2018 July 4;Starbucks;15.40;;;; 5'179.43;restaurants
2018 July 4;Uber;8.20;;;; 5'194.83;transport
2018 July 3;To Vacation savings;0.06;;;; 5'203.03;transfers
2018 July 3;To Vacation savings;0.80;;;; 5'203.09;transfers
2018 July 3;To Vacation savings;0.60;;;; 5'203.89;transfers
2018 July 3;Payment from Martin Alexander Tengelin Et/ou;; 5'000.00;;; 5'204.49;general
2018 July 3;To Vacation savings;0.10;;;; 204.49;transfers
2018 July 3;Coop Restaurant Genève Fusterie;3.80;;;; 204.59;groceries
2018 July 3;Globus Gastro Gen?ve;23.50;;;; 208.39;groceries
2018 July 2;Loja Relay Faro;19.52;;EUR 16.75;; 231.89;shopping
2018 July 2;Loja Relay Faro;4.43;;EUR 3.80;; 251.41;shopping
2018 July 2;Faro Airport;13.00;;EUR 11.15;; 255.84;restaurants
2018 July 2;Uber;26.49;;EUR 22.73;; 268.84;transport
2018 July 2;Coop Pronto Nyon;65.90;;;; 295.33;transport
2018 July 2;To Vacation savings;0.50;;;; 361.23;transfers
2018 July 2;To Vacation savings;0.20;;;; 361.73;transfers
2018 July 2;Tivoli Marinotel - Lak;125.83;;EUR 108.00;; 361.93;travel
2018 July 1;To Vacation savings;0.10;;;; 487.76;transfers
2018 July 1;To Vacation savings;1.00;;;; 487.86;transfers
2018 July 1;To Vacation savings;0.48;;;; 488.86;transfers
2018 July 1;To Vacation savings;0.57;;;; 489.34;transfers
2018 July 1;To Vacation savings;0.51;;;; 489.91;transfers
2018 June 30;To Vacation savings;0.17;;;; 490.42;transfers
2018 June 29;The Old Course Golf;277.07;;EUR 240.00;; 490.59;shopping
2018 June 29;Golfclubstroire;23.00;;EUR 19.95;; 767.66;shopping
2018 June 29;Dom Pedro;31.75;;EUR 27.50;; 790.66;travel
2018 June 29;Hotel Vila Gale Marina;2.89;;EUR 2.50;; 822.41;travel
2018 June 29;Hotel Vila Gale Marina;495.55;;EUR 430.00;; 825.30;travel
2018 June 29;Bistro de la Tour;20.70;;;; 1'320.85;restaurants
2018 June 29;The Clubhouse;36.00;;;; 1'341.55;restaurants
2018 June 29;The Clubhouse;18.00;;;; 1'377.55;restaurants
2018 June 29;Uber;27.54;;EUR 23.89;; 1'395.55;transport
2018 June 28;To Vacation savings;0.11;;;; 1'423.09;transfers
2018 June 28;To Vacation savings;0.93;;;; 1'423.20;transfers
2018 June 28;To Vacation savings;0.25;;;; 1'424.13;transfers
2018 June 28;To Vacation savings;0.45;;;; 1'424.38;transfers
2018 June 28;To Vacation savings;0.46;;;; 1'424.83;transfers
2018 June 28;To Vacation savings;1.00;;;; 1'425.29;transfers
2018 June 28;To Vacation savings;0.30;;;; 1'426.29;transfers
2018 June 27;To Vacation savings;1.00;;;; 1'426.59;transfers
2018 June 27;To Vacation savings;1.00;;;; 1'427.59;transfers
2018 June 26;From Charlotte Tengelin;; 600.00;;; 1'428.59;transfers
2018 June 26;Globus Gastro Gen?ve;17.50;;;; 828.59;groceries
2018 June 26;Kiosk Pam Cornavin;5.70;;;; 846.09;restaurants
2018 June 26;Intersoccer Sarl;525.00;;;; 851.79;travel
2018 June 25;Le Clavelin;68.41;;EUR 59.00;; 1'376.79;services
2018 June 25;To Vacation savings;0.50;;;; 1'445.20;transfers
2018 June 25;To Vacation savings;0.30;;;; 1'445.70;transfers
2018 June 25;Atac;347.18;;EUR 301.44;; 1'446.00;groceries
2018 June 25;Grand Cafe Real Sa;65.00;;;; 1'793.18;restaurants
2018 June 24;To Vacation savings;1.00;;;; 1'858.18;transfers
2018 June 24;To Vacation savings;0.59;;;; 1'859.18;transfers
2018 June 22;To Vacation savings;0.82;;;; 1'859.77;transfers
2018 June 22;Green Gorilla;17.90;;;; 1'860.59;restaurants
2018 June 22;To Vacation savings;1.00;;;; 1'878.49;transfers
2018 June 22;Ochsner Sport;149.80;;;; 1'879.49;shopping
2018 June 22;Coop-2201 Ge City Nf;14.95;;;; 2'029.29;groceries
2018 June 22;Coop Restaurant Genève Fusterie;72.30;;;; 2'044.24;groceries
2018 June 22;To Charlotte Tengelin;2'000.00;;;; 2'116.54;transfers
2018 June 21;Running Planet;899.00;;;; 4'116.54;shopping
2018 June 21;Pharmacie Principale *;31.90;;;; 5'015.54;health
2018 June 21;Sushi Haiku Sa;23.50;;;; 5'047.44;restaurants
2018 June 21;Brasserie De Rive;100.00;;;; 5'070.94;restaurants
2018 June 21;To Vacation savings;0.70;;;; 5'170.94;transfers
2018 June 21;To Vacation savings;0.05;;;; 5'171.64;transfers
2018 June 21;To Vacation savings;0.20;;;; 5'171.69;transfers
2018 June 21;To Vacation savings;0.10;;;; 5'171.89;transfers
2018 June 21;Migros M Fusterie;6.05;;;; 5'171.99;groceries
2018 June 21;Restaurant Wasabi;14.20;;;; 5'178.04;restaurants
2018 June 20;To Vacation savings;0.50;;;; 5'192.24;transfers
2018 June 20;To Vacation savings;0.10;;;; 5'192.74;transfers
2018 June 20;To Vacation savings;1.00;;;; 5'192.84;transfers
2018 June 20;Migros Mmm Nyon La Com;47.45;;;; 5'193.84;groceries
2018 June 20;Coop-2201 Ge City Nf;7.50;;;; 5'241.29;groceries
2018 June 19;Sumup  *leonardo Compa;39.00;;;; 5'248.79;restaurants
2018 June 19;Sumup  *leonardo Compa;5.00;;;; 5'287.79;restaurants
2018 June 19;Sumup  *leonardo Compa;1.70;;;; 5'292.79;restaurants
2018 June 19;To Vacation savings;1.00;;;; 5'294.49;transfers
2018 June 19;Cdg 2e Principa;19.24;;EUR 16.50;; 5'295.49;utilities
2018 June 19;Aig Caisse Auto Ep2 Pa;2.00;;;; 5'314.73;transport
2018 June 19;Mus? Historique;16.00;;;; 5'316.73;entertainment
2018 June 19;To Vacation savings;0.80;;;; 5'332.73;transfers
2018 June 19;To Vacation savings;0.95;;;; 5'333.53;transfers
2018 June 18;To Vacation savings;0.55;;;; 5'334.48;transfers
2018 June 18;To Matteo Vasirani;10.00;;;; 5'335.03;transfers
2018 June 18;To Vacation savings;0.50;;;; 5'345.03;transfers
2018 June 17;To Charlotte Tengelin;100.00;;;; 5'345.53;transfers
2018 June 17;To Vacation savings;1.00;;;; 5'445.53;transfers
2018 June 17;To Vacation savings;1.00;;;; 5'446.53;transfers
2018 June 17;To Vacation savings;0.30;;;; 5'447.53;transfers
2018 June 17;To Vacation savings;1.00;;;; 5'447.83;transfers
2018 June 16;To Vacation savings;1.00;;;; 5'448.83;transfers
2018 June 16;To Vacation savings;0.76;;;; 5'449.83;transfers
2018 June 14;Nike.com;133.99;;USD 135.94;; 5'450.59;general
2018 June 14;Rest Wolfgang Puck;4.89;;MXN 101.00;; 5'584.58;restaurants
2018 June 13;United01626007647305;25.75;;USD 26.00;; 5'589.47;travel
2018 June 13;Cash at Banco Santander;120.07;;MXN 2'484.80;; 5'615.22;cash
2018 June 12;Refund from Cash at Playa Del Carme;; 488.63;;; 5'735.29;general
2018 June 12;Cash at Playa Del Carme;488.63;;MXN 10'046.28;; 5'246.66;cash
2018 June 12;Cash at Banorte-mxn;370.20;;GBP 276.03;; 5'735.29;cash
2018 June 12;Amazon;25.50;;USD 25.90;; 6'105.49;entertainment
2018 June 11;To Vacation savings;0.01;;;; 6'130.99;transfers
2018 June 11;Keel Rest;26.56;;MXN 546.00;; 6'131.00;restaurants
2018 June 11;Deck 5 Skybar;8.08;;MXN 165.20;; 6'157.56;restaurants
2018 June 11;Xelbor Cab;38.40;;MXN 800.00;; 6'165.64;transport
2018 June 11;Amazon;85.64;;USD 86.99;; 6'204.04;entertainment
2018 June 11;To Vacation savings;0.11;;;; 6'289.68;transfers
2018 June 10;To Vacation savings;0.25;;;; 6'289.79;transfers
2018 June 9;To Vacation savings;0.92;;;; 6'290.04;transfers
2018 June 9;To Vacation savings;0.44;;;; 6'290.96;transfers
2018 June 8;Amazon;66.52;;USD 67.29;; 6'291.40;entertainment
2018 June 8;To Vacation savings;0.60;;;; 6'357.92;transfers
2018 June 7;Amende Radar Web;52.05;;EUR 45.00;; 6'358.52;general
2018 June 7;To Vacation savings;0.50;;;; 6'410.57;transfers
2018 June 7;To Vacation savings;0.36;;;; 6'411.07;transfers
2018 June 6;Paypal *payments;104.92;;USD 106.14;; 6'411.43;services
2018 June 6;Apple;178.50;;;; 6'516.35;shopping
2018 June 6;V.e.s.p.a;225.32;;SEK 2'000.00;; 6'694.85;restaurants
2018 June 6;Yosushi Cph T3 47;89.63;;DKK 576.00;; 6'920.17;restaurants
2018 June 6;Restaurant Wasabi;19.60;;;; 7'009.80;restaurants
2018 June 5;Klarna * Fyndiq Ab;19.83;;SEK 176.00;; 7'029.40;transport
2018 June 5;Bar Tgl Italia Ab;8.57;;SEK 76.00;; 7'049.23;restaurants
2018 June 5;Bar Tgl Italia Ab;11.84;;SEK 105.00;; 7'057.80;restaurants
2018 June 5;Smak Paa Malmo Konstha;3.27;;SEK 29.00;; 7'069.64;restaurants
2018 June 5;Klarna * Fyndiq Ab;6.34;;SEK 56.25;; 7'072.91;transport
2018 June 5;Klarna * Fyndiq Ab;4.23;;SEK 37.50;; 7'079.25;transport
2018 June 5;Maxi Ica Stormarknad V;8.56;;SEK 75.90;; 7'083.48;groceries
2018 June 4;To Vacation savings;0.95;;;; 7'092.04;transfers
2018 June 4;To Vacation savings;0.08;;;; 7'092.99;transfers
2018 June 4;To Vacation savings;0.50;;;; 7'093.07;transfers
2018 June 4;To Vacation savings;1.00;;;; 7'093.57;transfers
2018 June 4;Mc Donald's;21.40;;;; 7'094.57;restaurants
2018 June 4;To Vacation savings;0.40;;;; 7'115.97;transfers
2018 June 4;Steffs T3 Landside 56;9.89;;DKK 64.00;; 7'116.37;restaurants
2018 June 3;To Vacation savings;0.37;;;; 7'126.26;transfers
2018 June 3;To Vacation savings;0.17;;;; 7'126.63;transfers
2018 June 3;To Vacation savings;0.68;;;; 7'126.80;transfers
2018 June 3;To Vacation savings;0.43;;;; 7'127.48;transfers
2018 June 3;To Vacation savings;0.16;;;; 7'127.91;transfers
2018 June 2;To Vacation savings;0.44;;;; 7'128.07;transfers
2018 June 2;To Vacation savings;0.66;;;; 7'128.51;transfers
2018 June 2;To Vacation savings;0.73;;;; 7'129.17;transfers
2018 June 2;To Vacation savings;0.77;;;; 7'129.90;transfers
2018 June 2;Top-up via transfer;; 5'000.00;;; 7'130.67;general
2018 June 1;Klarna * Fyndiq Ab;12.30;;SEK 110.00;; 2'130.67;transport
2018 June 1;Gebr Heinemann Retail;44.33;;DKK 287.00;; 2'142.97;shopping
2018 June 1;Top-up via transfer;; 2'000.00;;; 2'187.30;general
2018 May 31;Coop Pronto Nyon;77.00;;;; 187.30;transport
2018 May 31;To Vacation savings;0.11;;;; 264.30;transfers
2018 May 31;To Vacation savings;0.67;;;; 264.41;transfers
2018 May 31;To Vacation savings;0.70;;;; 265.08;transfers
2018 May 31;To Vacation savings;0.60;;;; 265.78;transfers
2018 May 30;To Vacation savings;1.00;;;; 266.38;transfers
2018 May 26;Easyjet;382.12;;;; 267.38;travel
2018 May 24;To Vacation savings;0.88;;;; 649.50;transfers
2018 May 23;Arlanda Express;32.10;;SEK 280.00;; 650.38;transport
2018 May 22;Schweiz. Bundesbahn;7.70;;;; 682.48;transport
2018 May 22;Adf Principale;8.20;;;; 690.18;shopping
2018 May 22;Caviar House Seafood B;40.00;;;; 698.38;restaurants
2018 May 22;Lionel B.;130.00;;;; 738.38;services
2018 May 22;Loka Brunn Kur   Konf;24.67;;SEK 215.00;; 868.38;travel
2018 May 22;Loka Brunn Kur   Konf;484.23;;SEK 4'220.00;; 893.05;travel
2018 May 22;Circle K Enkoping Sala;21.13;;SEK 184.13;; 1'377.28;transport
2018 May 21;Bokhandeln;172.67;;SEK 1'505.00;; 1'398.41;entertainment
2018 May 21;Hmshost Amsterdam Schi;14.63;;SEK 128.00;; 1'571.08;restaurants
2018 May 21;To Vacation savings;0.90;;;; 1'585.71;transfers
2018 May 21;Systemb Hallstahammar;91.20;;SEK 799.50;; 1'586.61;shopping
2018 May 20;To Vacation savings;0.87;;;; 1'677.81;transfers
2018 May 20;To Vacation savings;0.33;;;; 1'678.68;transfers
2018 May 20;To Vacation savings;0.77;;;; 1'679.01;transfers
2018 May 19;To Vacation savings;0.33;;;; 1'679.78;transfers
2018 May 18;To Vacation savings;0.80;;;; 1'680.11;transfers
2018 May 18;To Vacation savings;0.37;;;; 1'680.91;transfers
2018 May 18;To Vacation savings;1.00;;;; 1'681.28;transfers
2018 May 18;To Vacation savings;0.80;;;; 1'682.28;transfers
2018 May 18;To Vacation savings;0.30;;;; 1'683.08;transfers
2018 May 18;To Vacation savings;1.00;;;; 1'683.38;transfers
2018 May 18;Globus Gastro Gen?ve;23.50;;;; 1'684.38;groceries
2018 May 17;Restaurant Mekong;23.00;;;; 1'707.88;restaurants
2018 May 17;Grand Cafe Real Sa;27.80;;;; 1'730.88;restaurants
2018 May 17;To Vacation savings;0.50;;;; 1'758.68;transfers
2018 May 17;Swisscom (schweiz) Ag;19.90;;;; 1'759.18;services
2018 May 17;Pharmacie-parf. Sunsto;5.20;;;; 1'779.08;health
2018 May 17;Pharmacie-parf. Sunsto;83.70;;;; 1'784.28;health
2018 May 16;To Vacation savings;1.00;;;; 1'867.98;transfers
2018 May 16;Boucherie-espace Molar;16.50;;;; 1'868.98;groceries
2018 May 16;To Vacation savings;0.80;;;; 1'885.48;transfers
2018 May 16;To Vacation savings;0.30;;;; 1'886.28;transfers
2018 May 16;To Vacation savings;0.10;;;; 1'886.58;transfers
2018 May 16;To Vacation savings;0.20;;;; 1'886.68;transfers
2018 May 16;Green Gorilla;19.90;;;; 1'886.88;restaurants
2018 May 16;Ochsner Sport ;32.00;;;; 1'906.78;shopping
2018 May 15;Les Palmiers;96.31;;EUR 80.10;; 1'938.78;restaurants
2018 May 15;Easyjetev51xj4;419.49;;DKK 2'604.27;; 2'035.09;travel
2018 May 15;Mc Donald's;26.93;;EUR 22.40;; 2'454.58;restaurants
2018 May 15;Les 2 Freres;134.04;;EUR 111.50;; 2'481.51;restaurants
2018 May 15;To Vacation savings;0.50;;;; 2'615.55;transfers
2018 May 15;M Jerome Buono;13.75;;EUR 11.49;; 2'616.05;groceries
2018 May 15;Paloma Beach;55.90;;EUR 46.50;; 2'629.80;restaurants
2018 May 15;Paloma Beach;192.35;;EUR 160.00;; 2'685.70;restaurants
2018 May 14;Bazar Et Chiffon;341.17;;EUR 283.80;; 2'878.05;utilities
2018 May 14;Casa;646.60;;EUR 541.96;; 3'219.22;utilities
2018 May 14;To Vacation savings;1.00;;;; 3'865.82;transfers
2018 May 14;To Vacation savings;0.10;;;; 3'866.82;transfers
2018 May 13;To Vacation savings;0.07;;;; 3'866.92;transfers
2018 May 13;To Vacation savings;0.51;;;; 3'866.99;transfers
2018 May 13;To Vacation savings;0.69;;;; 3'867.50;transfers
2018 May 12;To Vacation savings;0.96;;;; 3'868.19;transfers
2018 May 12;To Vacation savings;0.83;;;; 3'869.15;transfers
2018 May 12;To Vacation savings;0.10;;;; 3'869.98;transfers
2018 May 12;To Vacation savings;0.65;;;; 3'870.08;transfers
2018 May 11;Le Cosmo;125.30;;EUR 105.00;; 3'870.73;restaurants
2018 May 11;Carrefourmarket;233.77;;EUR 195.63;; 3'996.03;groceries
2018 May 11;To Vacation savings;0.25;;;; 4'229.80;transfers
2018 May 11;To Vacation savings;0.40;;;; 4'230.05;transfers
2018 May 11;Schweiz. Bundesbahn;4.50;;;; 4'230.45;transport
2018 May 11;Festival Cafe;126.54;;EUR 106.20;; 4'234.95;restaurants
2018 May 11;Starbucks;14.70;;;; 4'361.49;restaurants
2018 May 10;Cash at Ciclb Orange 1;107.24;;EUR 90.00;; 4'376.19;cash
2018 May 10;Roc31776prtdrome;26.79;;EUR 22.50;; 4'483.43;transport
2018 May 10;To Vacation savings;0.23;;;; 4'510.22;transfers
2018 May 10;To Vacation savings;0.70;;;; 4'510.45;transfers
2018 May 10;Easyjetev3kqhj;237.08;;DKK 1'483.98;; 4'511.15;travel
2018 May 9;To Vacation savings;0.46;;;; 4'748.23;transfers
2018 May 9;To Vacation savings;0.21;;;; 4'748.69;transfers
2018 May 9;Globus Gastro Gen?ve;17.50;;;; 4'748.90;groceries
2018 May 9;To Vacation savings;0.30;;;; 4'766.40;transfers
2018 May 9;Hotels.com147887378587;16.85;;;; 4'766.70;travel
2018 May 9;To Vacation savings;0.50;;;; 4'783.55;transfers
2018 May 8;Coop-1919 Ge City Food;60.75;;;; 4'784.05;groceries
2018 May 8;Restaurant Wasabi;12.80;;;; 4'844.80;restaurants
2018 May 8;To Vacation savings;0.15;;;; 4'857.60;transfers
2018 May 8;To Vacation savings;0.92;;;; 4'857.75;transfers
2018 May 8;To Vacation savings;0.50;;;; 4'858.67;transfers
2018 May 8;Pacific Outfi Face;7.57;;USD 7.56;; 4'859.17;shopping
2018 May 7;To Vacation savings;0.25;;;; 4'866.74;transfers
2018 May 7;Interdiscount-3102 Sig;56.85;;;; 4'866.99;shopping
2018 May 7;Sfmoma Museumstore Sfo;49.17;;USD 49.13;; 4'923.84;shopping
2018 May 7;To Vacation savings;0.20;;;; 4'973.01;transfers
2018 May 7;Walgreens;24.41;;USD 24.39;; 4'973.21;health
2018 May 7;Amazon Retail Llc Sf01;184.69;;USD 184.53;; 4'997.62;utilities
2018 May 5;To Vacation savings;0.15;;;; 5'182.31;transfers
2018 May 4;To Vacation savings;0.43;;;; 5'182.46;transfers
2018 May 4;To Vacation savings;0.83;;;; 5'182.89;transfers
2018 May 4;To Vacation savings;0.59;;;; 5'183.72;transfers
2018 May 4;To Vacation savings;0.31;;;; 5'184.31;transfers
2018 May 3;Top-up via transfer;; 5'000.00;;; 5'184.62;general
2018 May 2;Le D?barcad?re;160.00;;;; 184.62;restaurants
2018 May 1;La Plage De Nyon;72.20;;;; 344.62;restaurants
2018 May 1;Coop Pronto Nyon;32.60;;;; 416.82;transport
2018 May 1;Fb Fundraiser;6.00;;;; 449.42;services
2018 April 30;Starbucks;10.70;;;; 455.42;restaurants
2018 April 30;Globus Gastro Gen?ve;23.50;;;; 466.12;groceries
2018 April 30;Cafe Des Arts;50.00;;;; 489.62;restaurants
2018 April 29;Bosphore-resto;28.40;;;; 539.62;restaurants
2018 April 29;Transatel;29.92;;EUR 25.00;; 568.02;services
2018 April 29;Globus Gastro Gen?ve;18.00;;;; 597.94;groceries
2018 April 29;Paytrail*isocket Syste;206.17;;EUR 172.30;; 615.94;utilities
2018 April 29;Grand Cafe Real Sa;26.80;;;; 822.11;restaurants
2018 April 29;Restaurant Mekong;23.00;;;; 848.91;restaurants
2018 April 29;Icebreaker_eu;286.60;;;; 871.91;shopping
2018 April 28;Restaurant Wasabi;19.80;;;; 1'158.51;restaurants
2018 April 28;Green Gorilla;16.90;;;; 1'178.31;restaurants
2018 April 27;Migros Mmm Nyon La Com;41.40;;;; 1'195.21;groceries
2018 April 27;Migros M Fusterie;14.75;;;; 1'236.61;groceries
2018 April 27;Cash at Br Nyon;40.00;;;; 1'251.36;cash
2018 April 27;Sumup  *pb Pain Et Bri;43.20;;;; 1'291.36;restaurants
2018 April 26;Shell Station-service;65.95;;;; 1'334.56;transport
2018 April 26;Boucherie-espace Molar;16.50;;;; 1'400.51;groceries
2018 April 23;To Charlotte Tengelin;1'000.00;;;; 1'417.01;transfers
2018 April 21;Top-up via transfer;; 2'000.00;;; 2'417.01;general
2018 April 20;Globus Gastro Gen?ve;13.00;;;; 417.01;groceries
2018 April 20;Coop Pronto Nyon;26.60;;;; 430.01;transport
2018 April 20;Llao Llao;8.90;;;; 456.61;groceries
2018 April 20;La Plage De Nyon;75.00;;;; 465.51;restaurants
2018 April 19;To Charlotte Tengelin;350.00;;;; 540.51;transfers
2018 April 18;Sumup  *street Gourmet;9.00;;;; 890.51;restaurants
2018 April 18;Globus Gastro Gen?ve;12.90;;;; 899.51;groceries
2018 April 18;Green Gorilla;16.90;;;; 912.41;restaurants
2018 April 17;Green Gorilla;19.90;;;; 929.31;restaurants
2018 April 17;Coop-1281 Verbier;53.50;;;; 949.21;groceries
2018 April 16;Mountain-air Hardware;76.30;;;; 1'002.71;shopping
2018 April 16;Happy Sushi S?rl;28.00;;;; 1'079.01;restaurants
2018 April 16;Coop Pronto Montreux;16.20;;;; 1'107.01;groceries
2018 April 16;Uber Bv;10.81;;;; 1'123.21;transport
2018 April 15;To Patrik Hyberg;50.00;;;; 1'134.02;transfers
2018 April 13;Mc Donald's;6.10;;;; 1'184.02;restaurants
2018 April 13;Grand Cafe Real Sa;28.00;;;; 1'190.12;restaurants
2018 April 13;Amazon;27.60;;USD 28.82;; 1'218.12;entertainment
2018 April 12;To Patrik Hyberg;135.00;;;; 1'245.72;transfers
2018 April 12;Migros M Fusterie;9.00;;;; 1'380.72;groceries
2018 April 11;To Adrien De Castro;14.00;;;; 1'389.72;transfers
2018 April 11;Globus Gastro Gen?ve;14.30;;;; 1'403.72;groceries
2018 April 11;Globus Gastro Gen?ve;23.50;;;; 1'418.02;groceries
2018 April 11;Coop Pronto Nyon;28.35;;;; 1'441.52;transport
2018 April 10;To Patrik Hyberg;10.00;;;; 1'469.87;transfers
2018 April 10;Molino Molard Ge;80.00;;;; 1'479.87;restaurants
2018 April 10;Diesel Gen?ve Touzeau;179.00;;;; 1'559.87;shopping
2018 April 9;Parking Du Mont-blanc;24.00;;;; 1'738.87;services
2018 April 9;Restaurant Le Dahu Sa;45.50;;;; 1'762.87;restaurants
2018 April 9;Coop-2201 Ge City Nf;3.10;;;; 1'808.37;groceries
2018 April 9;Globus Gastro Gen?ve;52.50;;;; 1'811.47;groceries
2018 April 9;Brasserie De Rive;84.00;;;; 1'863.97;restaurants
2018 April 6;Mc Donald's;6.10;;;; 1'947.97;restaurants
2018 April 6;From Matteo Vasirani;; 23.50;;; 1'954.07;transfers
2018 April 6;Sbb Cff Ffs Mobile Tic;4.50;;;; 1'930.57;transport
2018 April 6;Boucherie-espace Molar;31.50;;;; 1'935.07;groceries
2018 April 6;Grand Cafe Real Sa;34.80;;;; 1'966.57;restaurants
2018 April 5;Sbb Cff Ffs Mobile Tic;4.50;;;; 2'001.37;transport
2018 April 5;Sbb Cff Ffs Mobile Tic;4.50;;;; 2'005.87;transport
2018 April 4;Les Palmiers;37.84;;EUR 32.00;; 2'010.37;restaurants
2018 April 4;Sbb Cff Ffs Mobile Tic;15.40;;;; 2'048.21;transport
2018 April 4;La Caravelle;76.26;;EUR 64.80;; 2'063.61;restaurants
2018 April 4;Villa D'este;118.69;;EUR 101.00;; 2'139.87;restaurants
2018 April 4;To Charlotte Tengelin;2'000.00;;;; 2'258.56;transfers
2018 April 4;Top-up via transfer;; 4'000.00;;; 4'258.56;general
2018 April 4;Les 2 Freres;117.48;;EUR 100.00;; 258.56;restaurants
2018 April 3;Nespresso Franc;65.13;;EUR 55.40;; 376.04;general
2018 April 3;Banana Cafe;89.52;;EUR 75.70;; 441.17;restaurants
2018 April 3;Uber;17.78;;EUR 15.12;; 530.69;transport
2018 April 3;Uber;1.18;;EUR 1.00;; 548.47;transport
2018 April 3;Uber;26.86;;EUR 22.85;; 549.65;transport
2018 April 3;Cash at Ce Cote D Azur;117.88;;EUR 100.00;; 576.51;cash
2018 April 3;Le Cellier;44.60;;;; 694.39;restaurants
2018 April 3;Superettethorel;24.09;;EUR 20.48;; 738.99;groceries
2018 March 29;Grand Cafe Real Sa;29.80;;;; 763.08;restaurants
2018 March 29;Sbb Cff Ffs Mobile Tic;2.00;;;; 792.88;transport
2018 March 29;Sbb Cff Ffs Mobile Tic;4.50;;;; 794.88;transport
2018 March 29;Migros Mmm Nyon La Com;2.10;;;; 799.38;groceries
2018 March 28;Sbb Cff Ffs Mobile Tic;4.50;;;; 801.48;transport
2018 March 28;Sbb Cff Ffs Mobile Tic;4.50;;;; 805.98;transport
2018 March 28;Boucherie-espace Molar;16.50;;;; 810.48;groceries
2018 March 27;Green Gorilla;16.90;;;; 826.98;restaurants
2018 March 27;Sbb Cff Ffs Mobile Tic;2.00;;;; 843.88;transport
2018 March 27;Sbb Cff Ffs Mobile Tic;2.00;;;; 845.88;transport
2018 March 27;Sbb Cff Ffs Mobile Tic;4.50;;;; 847.88;transport
2018 March 27;Sbb Cff Ffs Mobile Tic;4.50;;;; 852.38;transport
2018 March 27;Coop-5467 Ge Aperto Ga;2.10;;;; 856.88;groceries
2018 March 27;Ochsner Sport ;37.80;;;; 858.98;shopping
2018 March 27;Migros Mmm Nyon La Com;121.05;;;; 896.78;groceries
2018 March 27;Pharmacie Principale *;12.90;;;; 1'017.83;health
2018 March 27;Le D?barcad?re;70.80;;;; 1'030.73;restaurants
2018 March 27;Boulangerie Bonnin;22.00;;;; 1'101.53;groceries
2018 March 26;Sbb Cff Ffs Mobile Tic;15.40;;;; 1'123.53;transport
2018 March 26;Sbb Cff Ffs Mobile Tic;7.70;;;; 1'138.93;transport
2018 March 24;To Charlotte Tengelin;1'000.00;;;; 1'146.63;transfers
2018 March 23;Top-up via transfer;; 2'000.00;;; 2'146.63;general
2018 March 23;Fb Fundraiser;37.00;;;; 146.63;services
2018 March 22;Aramark Sap Center;5.02;;USD 5.25;; 183.63;restaurants
2018 March 21;To Charlotte Tengelin;500.00;;;; 188.65;transfers
2018 March 21;Ea Experience;21.44;;USD 22.55;; 688.65;services
2018 March 20;Rangoon Ruby Burme;57.74;;USD 60.69;; 710.09;restaurants
2018 March 20;Sbb Cff Ffs Mobile Tic;15.40;;;; 767.83;transport
2018 March 20;Presidio - Arguello;48.44;;USD 50.59;; 783.23;restaurants
2018 March 20;Exchanged from GBP;; 62.26;;GBP 46.64; 831.67;general
2018 March 20;Blue  Gold Fleet 2;66.98;;USD 70.00;; 769.41;transport
2018 March 19;Icebreaker San Fran;731.13;;USD 763.84;; 836.39;shopping
2018 March 19;Uniguest;3.36;;USD 3.50;; 1'567.52;services
2018 March 19;Uber;7.62;;USD 7.96;; 1'570.88;transport
2018 March 19;Presidio - The Commiss;103.38;;USD 108.00;; 1'578.50;restaurants
2018 March 19;Sports Basement;124.63;;USD 130.20;; 1'681.88;shopping
2018 March 19;Walgreens;2.84;;USD 2.96;; 1'806.51;health
2018 March 19;Uber;10.21;;USD 10.66;; 1'809.35;transport
2018 March 19;Uber;7.42;;USD 7.75;; 1'819.56;transport
2018 March 19;Uber;18.44;;USD 19.26;; 1'826.98;transport
2018 March 19;Gnc #01569;3.16;;USD 3.30;; 1'845.42;groceries
2018 March 19;Apple;82.01;;USD 85.67;; 1'848.58;shopping
2018 March 19;Gap Us 9604;47.15;;USD 49.25;; 1'930.59;shopping
2018 March 19;The Ups Store #6431;3.40;;USD 3.55;; 1'977.74;services
2018 March 19;Squ*sq *parkwide Inc;27.76;;USD 29.00;; 1'981.14;shopping
2018 March 19;Nike San Fran 086;248.22;;USD 259.32;; 2'008.90;shopping
2018 March 19;Mc Donald's;13.30;;;; 2'257.12;restaurants
2018 March 19;Boutique Jf3;12.90;;;; 2'270.42;shopping
2018 March 16;Aim? Pouly Sa;8.30;;;; 2'283.32;groceries
2018 March 16;Sbb Cff Ffs Mobile Tic;4.50;;;; 2'291.62;transport
2018 March 16;Sbb Cff Ffs Mobile Tic;4.50;;;; 2'296.12;transport
2018 March 16;Boucherie-espace Molar;16.50;;;; 2'300.62;groceries
2018 March 16;Migros Mmm Nyon La Com;17.00;;;; 2'317.12;groceries
2018 March 15;Restaurant Mekong;41.00;;;; 2'334.12;restaurants
2018 March 15;Sbb Cff Ffs Mobile Tic;7.70;;;; 2'375.12;transport
2018 March 15;Dixons;197.14;;GBP 149.00;; 2'382.82;shopping
2018 March 13;Montreux Jazz Shop;34.80;;;; 2'579.96;restaurants
2018 March 13;Starbucks;9.70;;;; 2'614.76;restaurants
2018 March 13;Sbb Cff Ffs Mobile Tic;1.80;;;; 2'624.46;transport
2018 March 13;Easyjetetrw2r9;142.99;;;; 2'626.26;travel
2018 March 12;Ikea Schweiz;99.80;;;; 2'769.25;utilities
2018 March 12;Brasserie Le Bec;103.70;;;; 2'869.05;restaurants
2018 March 12;Coop-1281 Verbier;37.20;;;; 2'972.75;groceries
2018 March 12;Ikea Sa Aubonne;338.45;;;; 3'009.95;utilities
2018 March 12;Restaurant Le Rouge;80.00;;;; 3'348.40;restaurants
2018 March 12;Green Gorilla;16.90;;;; 3'428.40;restaurants
2018 March 12;Sbb Cff Ffs Mobile Tic;4.50;;;; 3'445.30;transport
2018 March 12;Sbb Cff Ffs Mobile Tic;4.50;;;; 3'449.80;transport
2018 March 12;Migros M Fusterie;6.05;;;; 3'454.30;groceries
2018 March 12;Ikea Sa Aubonne;11.90;;;; 3'460.35;utilities
2018 March 9;To Andrew Terrett;1.00;;;; 3'472.25;transfers
2018 March 9;Grand Cafe Real Sa;110.50;;;; 3'473.25;restaurants
2018 March 9;Grand Cafe Real Sa;22.80;;;; 3'583.75;restaurants
2018 March 9;Sbb Cff Ffs Mobile Tic;4.50;;;; 3'606.55;transport
2018 March 9;Sbb Cff Ffs Mobile Tic;4.50;;;; 3'611.05;transport
2018 March 9;Ikea Schweiz;79.90;;;; 3'615.55;utilities
2018 March 9;Globus Gastro Gen?ve;13.00;;;; 3'695.45;groceries
2018 March 9;Migros Mmm Nyon La Com;17.90;;;; 3'708.45;groceries
2018 March 9;Starbucks Coffe;11.30;;;; 3'726.35;restaurants
2018 March 8;Schweiz. Bundesbahn;4.50;;;; 3'737.65;transport
2018 March 8;Apple Store R275;98.25;;;; 3'742.15;shopping
2018 March 8;Globus Gastro Gen?ve;11.00;;;; 3'840.40;groceries
2018 March 7;Boucherie-espace Molar;11.80;;;; 3'851.40;groceries
2018 March 6;Green Gorilla;21.80;;;; 3'863.20;restaurants
2018 March 6;Parking Villereuse;14.00;;;; 3'885.00;transport
2018 March 6;Migros M Fusterie;6.70;;;; 3'899.00;groceries
2018 March 6;Manor Ag - 315;94.70;;;; 3'905.70;shopping
2018 March 5;Schweiz. Bundesbahn;4.50;;;; 4'000.40;transport
2018 March 2;Top-up via transfer;; 4'000.00;;; 4'004.90;general
2018 March 2;Globus Gastro Gen?ve;17.50;;;; 4.90;groceries
2018 February 28;Globus Gastro Gen?ve;23.50;;;; 22.40;groceries
2018 February 27;Green Gorilla;19.90;;;; 45.90;restaurants
2018 February 27;Migros M Fusterie;12.25;;;; 65.80;groceries
2018 February 27;Parking Gare De Nyon;3.00;;;; 78.05;transport
2018 February 26;Mountain-air Hardware;38.40;;;; 81.05;shopping
2018 February 26;Coop-1281 Verbier;32.15;;;; 119.45;groceries
2018 February 26;Coop-1281 Verbier;61.55;;;; 151.60;groceries
2018 February 26;Restaurant Luigia Nyon;78.00;;;; 213.15;restaurants
2018 February 26;Igloo Du Mont Fort;20.10;;;; 291.15;restaurants
2018 February 26;Restaurant Croix-de-co;193.60;;;; 311.25;restaurants
2018 February 26;T?l?verbier Sa;54.00;;;; 504.85;transport
2018 February 26;W Verbier  Residences;39.00;;;; 558.85;travel
2018 February 26;W Verbier  Residences;11.00;;;; 597.85;travel
2018 February 25;To Charlotte Tengelin;1'045.00;;;; 608.85;transfers
2018 February 25;From Charlotte Tengelin;; 600.00;;; 1'653.85;transfers
2018 February 23;Restaurant Carlsberg;51.00;;;; 1'053.85;restaurants
2018 February 23;Mountain-air Sa;31.50;;;; 1'104.85;shopping
2018 February 22;Food Court Noville;31.70;;;; 1'136.35;restaurants
2018 February 22;Wh Smith;9.08;;SEK 78.00;; 1'168.05;restaurants
2018 February 21;Geneve-aeroport Cff;15.40;;;; 1'177.13;transport
2018 February 21;Coop-1281 Verbier;140.50;;;; 1'192.53;groceries
2018 February 21;Ikea Sa Aubonne;44.49;;;; 1'333.03;utilities
2018 February 21;Sibylla Drive;7.10;;SEK 61.00;; 1'377.52;restaurants
2018 February 20;Exchanged to BTC;100.00;;BTC  0.00915656;; 1'384.62;general
2018 February 20;Sky Cafe;15.48;;SEK 133.00;; 1'484.62;restaurants
2018 February 20;Ica Supermarket Tunaba;5.50;;SEK 47.30;; 1'500.10;groceries
2018 February 19;Uppsala Konsert  Kong;29.40;;SEK 251.00;; 1'505.60;entertainment
2018 February 19;Wh Smith;8.02;;SEK 69.00;; 1'535.00;restaurants
2018 February 19;World Of Toys Terminal;54.38;;SEK 468.00;; 1'543.02;shopping
2018 February 16;Mc Donald's;11.50;;;; 1'597.40;restaurants
2018 February 16;Interdiscount-3584 Ge;8.85;;;; 1'608.90;shopping
2018 February 16;H  M;115.70;;;; 1'617.75;shopping
2018 February 16;H  M;12.95;;;; 1'733.45;shopping
2018 February 16;Boucherie-espace Molar;16.50;;;; 1'746.40;groceries
2018 February 16;Cafe Des Arts;89.50;;;; 1'762.90;restaurants
2018 February 15;Brin De Folie;52.00;;;; 1'852.40;shopping
2018 February 15;Grand Cafe Real Sa;22.80;;;; 1'904.40;restaurants
2018 February 14;Exchanged to BTC;100.00;;BTC  0.01137084;; 1'927.20;general
2018 February 14;Vino Olio Caffe;80.00;;;; 2'027.20;restaurants
2018 February 14;Pharmacie Principale *;53.20;;;; 2'107.20;health
2018 February 13;Grand Cafe Real Sa;49.50;;;; 2'160.40;restaurants
2018 February 13;Migros Mmm Nyon La Com;20.95;;;; 2'209.90;groceries
2018 February 12;Coop Pronto Nyon;49.00;;;; 2'230.85;transport
2018 February 12;Joutec;35.90;;;; 2'279.85;shopping
2018 February 12;Quai 23 Sarl;20.00;;;; 2'315.75;restaurants
2018 February 12;Easyjet;407.43;;;; 2'335.75;travel
2018 February 12;Globus Gastro Gen?ve;8.80;;;; 2'743.18;groceries
2018 February 12;Globus Gastro Gen?ve;46.50;;;; 2'751.98;groceries
2018 February 9;Boucherie-espace Molar;16.50;;;; 2'798.48;groceries
2018 February 8;To Göran Tengelin;1.00;;;; 2'814.98;transfers
2018 February 8;Restaurant Mekong;41.00;;;; 2'815.98;restaurants
2018 February 8;Grand Cafe Real Sa;38.00;;;; 2'856.98;restaurants
2018 February 7;Green Gorilla;19.90;;;; 2'894.98;restaurants
2018 February 6;Exchanged to BTC;100.00;;BTC  0.01525568;; 2'914.88;general
2018 February 6;Green Gorilla;16.90;;;; 3'014.88;restaurants
2018 February 6;Top-up via transfer;; 2'000.00;;; 3'031.78;general
2018 February 6;Pharmacie Principale *;14.10;;;; 1'031.78;health
2018 February 6;Brasserie De Rive;104.90;;;; 1'045.88;restaurants
2018 February 6;Le D?barcad?re;77.50;;;; 1'150.78;restaurants
2018 February 5;Angelika Chollet;37.00;;;; 1'228.28;shopping
2018 February 5;Coop Pronto Nyon;40.25;;;; 1'265.28;transport
2018 February 5;Saint James Lo Du Lac;130.00;;;; 1'305.53;shopping
2018 February 5;Easyjet;382.90;;;; 1'435.53;travel
2018 February 5;Easyjet;136.21;;;; 1'818.43;travel
2018 February 5;Easyjet;457.62;;;; 1'954.64;travel
2018 February 5;Restaurant Inglewood;149.00;;;; 2'412.26;restaurants
2018 February 5;Migros M Fusterie;12.50;;;; 2'561.26;groceries
2018 February 3;From Charlotte Tengelin;; 500.00;;; 2'573.76;transfers
2018 February 2;To Charlotte Tengelin;2'000.00;;;; 2'073.76;transfers
2018 February 2;From Adrien De Castro;; 31.00;;; 4'073.76;transfers
2018 February 2;From Matteo Vasirani;; 25.00;;; 4'042.76;transfers
2018 February 2;Top-up via transfer;; 4'000.00;;; 4'017.76;general
2018 February 2;Boucherie-espace Molar;16.50;;;; 17.76;groceries
2018 February 1;Grand Cafe Real Sa;38.00;;;; 34.26;restaurants
2018 January 31;Exchanged to BTC;100.00;;BTC  0.01031196;; 72.26;general
2018 January 31;Boucherie-espace Molar;16.50;;;; 172.26;groceries
2018 January 30;Mc Donald's;25.10;;;; 188.76;restaurants
2018 January 30;Globus Gastro Gen?ve;17.50;;;; 213.86;groceries
2018 January 30;Migros Mmm Nyon La Com;26.40;;;; 231.36;groceries
2018 January 29;Scalco Sa;111.20;;;; 257.76;groceries
2018 January 29;Restaurant Le Dahu Sa;90.60;;;; 368.96;restaurants
2018 January 29;Le Shed;145.00;;;; 459.56;restaurants
2018 January 29;Remont?es M?caniques L;48.00;;;; 604.56;transport
2018 January 29;Remont?es M?caniques L;10.00;;;; 652.56;transport
2018 January 29;Migrolino Martigny;2.90;;;; 662.56;groceries
2018 January 29;Pouly Sa 4569;8.50;;;; 665.46;groceries
2018 January 27;To Charlotte Tengelin;500.00;;;; 673.96;transfers
2018 January 26;To Adrien De Castro;14.00;;;; 1'173.96;transfers
2018 January 26;Coop Pronto Nyon;34.50;;;; 1'187.96;transport
2018 January 26;Taxi Lic 5476;31.17;;EUR 26.65;; 1'222.46;transport
2018 January 24;Exchanged to BTC;100.00;;BTC  0.00923437;; 1'253.63;general
2018 January 24;Hotel Arts;87.14;;EUR 74.00;; 1'353.63;travel
2018 January 24;3531 Food Market T5b;4.44;;SEK 37.00;; 1'440.77;restaurants
2018 January 24;News  Fine Food 3540;9.58;;SEK 79.90;; 1'445.21;restaurants
2018 January 23;From Svante Horn;; 1'051.00;;; 1'454.79;transfers
2018 January 23;Taxi Lic 183;31.80;;EUR 26.95;; 403.79;transport
2018 January 23;Riche;168.73;;SEK 1'400.00;; 435.59;restaurants
2018 January 22;Cash at Br Nyon;80.00;;;; 604.32;cash
2018 January 22;Walktrough Dep;26.41;;EUR 22.50;; 684.32;shopping
2018 January 22;Migros Mm Porte De Nyo;189.25;;;; 710.73;groceries
2018 January 22;Starbucks Coffe;10.70;;;; 899.98;restaurants
2018 January 22;Millenium Pro Design S;41.68;;EUR 35.50;; 910.68;shopping
2018 January 22;Leftbank;24.21;;RON 96.00;; 952.36;restaurants
2018 January 18;Grand Cafe Real Sa;64.50;;;; 976.57;restaurants
2018 January 18;Uber;7.94;;RON 31.30;; 1'041.07;transport
2018 January 17;Restaurant Mekong;23.00;;;; 1'049.01;restaurants
2018 January 17;Globus Gastro Gen?ve;23.50;;;; 1'072.01;groceries
2018 January 17;Exchanged to BTC;100.00;;BTC  0.00919793;; 1'095.51;general
2018 January 16;Quai 23 Sarl;20.00;;;; 1'195.51;restaurants
2018 January 16;Green Gorilla;16.90;;;; 1'215.51;restaurants
2018 January 16;Pouly Sa 4569;7.50;;;; 1'232.41;groceries
2018 January 15;Scalco Sa;95.20;;;; 1'239.91;groceries
2018 January 15;Coop Pronto Nyon;20.70;;;; 1'335.11;transport
2018 January 15;Rest. Olympique  Cuck;18.90;;;; 1'355.81;restaurants
2018 January 15;Ikea Sa Aubonne;24.80;;;; 1'374.71;utilities
2018 January 15;Coop-1281 Verbier;30.70;;;; 1'399.51;groceries
2018 January 15;T?l?verbier Sa;65.00;;;; 1'430.21;transport
2018 January 15;Green Gorilla;16.90;;;; 1'495.21;restaurants
2018 January 15;Globus Gen?ve;15.50;;;; 1'512.11;shopping
2018 January 15;Ikea Sa Aubonne;2.95;;;; 1'527.61;utilities
2018 January 15;Ikea Sa Aubonne;47.60;;;; 1'530.56;utilities
2018 January 12;Globus Gastro Gen?ve;15.90;;;; 1'578.16;groceries
2018 January 11;Grand Cafe Real Sa;46.30;;;; 1'594.06;restaurants
2018 January 10;Exchanged to BTC;100.00;;BTC  0.00721709;; 1'640.36;general
2018 January 10;Migros Mmm Nyon La Com;19.95;;;; 1'740.36;groceries
2018 January 10;Globus Gastro Gen?ve;13.00;;;; 1'760.31;groceries
2018 January 9;Starbucks Coffee;18.30;;;; 1'773.31;restaurants
2018 January 9;Ochsner Sport ;89.80;;;; 1'791.61;shopping
2018 January 9;Boucherie-espace Molar;16.50;;;; 1'881.41;groceries
2018 January 9;Le D?barcad?re;85.00;;;; 1'897.91;restaurants
2018 January 8;Restaurant Mekong;23.00;;;; 1'982.91;restaurants
2018 January 8;Sumup  *pb Pain Et Bri;20.40;;;; 2'005.91;restaurants
2018 January 8;Parking Villereuse;13.00;;;; 2'026.31;transport
2018 January 8;Green Gorilla;19.90;;;; 2'039.31;restaurants
2018 January 5;To Charlotte Tengelin;2'000.00;;;; 2'059.21;transfers
2018 January 5;Top-up via transfer;; 4'000.00;;; 4'059.21;general
2018 January 5;Globus Gastro Gen?ve;17.50;;;; 59.21;groceries
2018 January 5;Pouly Sa 4569;8.50;;;; 76.71;groceries
2018 January 4;Exchanged from SEK;; 73.24;;SEK 611.98; 85.21;general
2018 January 3;Parking Automate;2.11;;EUR 1.80;; 11.97;general
2018 January 2;Exchanged to BTC;100.00;;BTC  0.00684673;; 14.08;general
2018 January 2;Exchanged from SEK;; 100.00;;SEK 841.05; 114.08;general
2018 January 2;Villa D'este;163.85;;EUR 140.00;; 14.08;restaurants
2018 January 2;El Ganso;486.09;;EUR 415.00;; 177.93;shopping
2018 January 2;Indigo 060005;18.15;;EUR 15.50;; 664.02;transport
2018 January 2;Kooples Nice;298.47;;EUR 255.00;; 682.17;shopping
2018 January 2;Pharmacie Lauren;7.83;;EUR 6.70;; 980.64;health
2018 January 2;Autost P.le Francese;159.01;;EUR 135.80;; 988.47;transport
2017 December 29;From Charlotte Tengelin;; 107.88;;; 1'147.48;transfers
2017 December 29;Andro   Co;222.72;;EUR 190.50;; 1'039.60;restaurants
2017 December 29;Caffe' Caboto;51.82;;EUR 44.00;; 1'262.32;restaurants
2017 December 28;Nuova Sidap Srl 91 936;106.88;;EUR 90.82;; 1'314.14;transport
2017 December 28;Mondovi'      -savona;2.95;;EUR 2.50;; 1'421.02;transport
2017 December 28;Cie Mont Blanc;149.81;;EUR 127.00;; 1'423.97;entertainment
2017 December 28;Trattoria Delle Vigne;103.30;;EUR 88.00;; 1'573.78;restaurants
2017 December 28;Azienda Agricola Sylla;205.53;;EUR 175.00;; 1'677.08;groceries
2017 December 28;Autost Torino;3.17;;EUR 2.70;; 1'882.61;transport
2017 December 28;Autost Aosta -m.bianco;28.17;;EUR 24.00;; 1'885.78;transport
2017 December 27;Remco Srl          001;110.18;;EUR 93.60;; 1'913.95;services
2017 December 27;Eva Baz Art;34.21;;EUR 29.00;; 2'024.13;utilities
2017 December 27;O Champs Paysans;34.52;;EUR 29.25;; 2'058.34;general
2017 December 27;Aux Petits Gourmand;5.52;;EUR 4.70;; 2'092.86;groceries
2017 December 27;Cash at La Banque Postal;236.64;;EUR 200.00;; 2'098.38;cash
2017 December 27;Cap Horn;152.76;;EUR 129.50;; 2'335.02;restaurants
2017 December 27;Sa Payot Pertin;35.88;;EUR 30.41;; 2'487.78;groceries
2017 December 27;Snell Sports;671.19;;EUR 569.00;; 2'523.66;shopping
2017 December 27;Rest La Cabane;137.83;;EUR 116.80;; 3'194.85;restaurants
2017 December 27;Boulangerie Bonnin;5.50;;;; 3'332.68;groceries
2017 December 27;Mountain Store;161.52;;EUR 136.88;; 3'338.18;services
2017 December 27;Grand Cafe Real Sa;74.00;;;; 3'499.70;restaurants
2017 December 26;Exchanged to BTC;100.00;;BTC  0.00628036;; 3'573.70;general
2017 December 23;Top-up via transfer;; 2'000.00;;; 3'673.70;general
2017 December 22;Green Gorilla;19.90;;;; 1'673.70;restaurants
2017 December 22;From Charlotte Tengelin;; 1'000.00;;; 1'693.60;transfers
2017 December 22;Pharmacie-parf. Sunsto;32.00;;;; 693.60;health
2017 December 22;Pharmacie Principale *;12.95;;;; 725.60;health
2017 December 22;Pouly Sa 4569;1.50;;;; 738.55;groceries
2017 December 21;Manor Ag - 315;23.00;;;; 740.05;groceries
2017 December 21;Sushi Haiku Sa;26.00;;;; 763.05;restaurants
2017 December 20;To Adrien De Castro;5.00;;;; 789.05;transfers
2017 December 20;To Matteo Vasirani;9.00;;;; 794.05;transfers
2017 December 20;Globus Gastro Gen?ve;17.50;;;; 803.05;groceries
2017 December 19;Exchanged to BTC;100.00;;BTC  0.00562336;; 820.55;general
2017 December 19;Restaurant Mekong;23.00;;;; 920.55;restaurants
2017 December 19;Globus Gastro Gen?ve;23.50;;;; 943.55;groceries
2017 December 19;Fb Fundraiser;20.00;;;; 967.05;services
2017 December 18;La Veranda;13.50;;;; 987.05;restaurants
2017 December 18;Cin?ma Rex Path?;12.70;;;; 1'000.55;entertainment
2017 December 18;Quai 23 Sarl;20.00;;;; 1'013.25;restaurants
2017 December 18;Pharmacie Principale *;68.80;;;; 1'033.25;health
2017 December 15;Green Gorilla;16.90;;;; 1'102.05;restaurants
2017 December 15;Migros M Fusterie;10.00;;;; 1'118.95;groceries
2017 December 15;Parking Du Mont-blanc;14.00;;;; 1'128.95;services
2017 December 14;Grand Cafe Real Sa;38.00;;;; 1'142.95;restaurants
2017 December 14;Globus Gastro Gen?ve;7.00;;;; 1'180.95;groceries
2017 December 14;Globus Gastro Gen?ve;29.00;;;; 1'187.95;groceries
2017 December 13;Schweiz. Bundesbahn;4.50;;;; 1'216.95;transport
2017 December 13;Sumup  *non Sequitur G;16.00;;;; 1'221.45;groceries
2017 December 12;Exchanged to BTC;100.00;;BTC  0.00593758;; 1'237.45;general
2017 December 12;Restaurant Mekong;41.00;;;; 1'337.45;restaurants
2017 December 12;Boucherie-espace Molar;16.50;;;; 1'378.45;groceries
2017 December 12;Parking Villereuse;9.00;;;; 1'394.95;transport
2017 December 12;Pouly Sa 4569;1.50;;;; 1'403.95;groceries
2017 December 12;Brezelk?nig Ag;4.00;;;; 1'405.45;groceries
2017 December 11;Exchanged from GBP;; 8.01;;GBP 6.06; 1'409.45;general
2017 December 11;Rando Burger;33.90;;;; 1'401.44;restaurants
2017 December 11;Quai 23 Sarl;20.00;;;; 1'435.34;restaurants
2017 December 11;Socar Nyon;148.60;;;; 1'455.34;transport
2017 December 11;Le Panetier;11.00;;;; 1'603.94;groceries
2017 December 11;Migros Fm Nyon;178.20;;;; 1'614.94;shopping
2017 December 11;Migros Mm Porte De Nyo;79.55;;;; 1'793.14;groceries
2017 December 11;Mc Donald's;3.70;;;; 1'872.69;restaurants
2017 December 11;Mc Donald's;15.80;;;; 1'876.39;restaurants
2017 December 11;Green Gorilla;19.90;;;; 1'892.19;restaurants
2017 December 11;Manor Ag - 315;33.35;;;; 1'912.09;groceries
2017 December 11;Manor Ag - 315;6.20;;;; 1'945.44;shopping
2017 December 11;Cafe Des Arts;62.50;;;; 1'951.64;restaurants
2017 December 10;Exchanged to BTC;20.00;;BTC  0.00153561;; 2'014.14;general
2017 December 9;To Charlotte Tengelin;2'000.00;;;; 2'034.14;transfers
2017 December 8;British Airways Tourve;13.94;;GBP 10.45;; 4'034.14;groceries
2017 December 8;Green Gorilla;16.90;;;; 4'048.08;restaurants
2017 December 8;Manor Ag - 315;25.35;;;; 4'064.98;groceries
2017 December 7;Top-up via transfer;; 3'000.00;;; 4'090.33;general
2017 December 6;To Adrien De Castro;10.00;;;; 1'090.33;transfers
2017 December 6;London Overground Sst;12.96;;GBP 9.80;; 1'100.33;transport
2017 December 6;Coop-2113 Ge City Rest;15.25;;;; 1'113.29;groceries
2017 December 5;Coop-1919 Ge City Food;5.90;;;; 1'128.54;groceries
2017 December 5;Coop-2201 Ge City Nf;27.95;;;; 1'134.44;groceries
2017 December 5;Globus Gastro Gen?ve;17.50;;;; 1'162.39;groceries
2017 December 5;Heathrow Express;29.10;;GBP 22.00;; 1'179.89;transport
2017 December 4;Pret A Manger;9.23;;GBP 6.97;; 1'208.99;restaurants
2017 December 4;Dixons Travel;81.89;;GBP 61.92;; 1'218.22;shopping
2017 December 4;Boots;13.15;;GBP 9.94;; 1'300.11;health
2017 December 4;Itsu;26.99;;GBP 20.41;; 1'313.26;restaurants
2017 December 4;Cash at Changegroup Spitalfie;132.31;;GBP 100.00;; 1'340.25;cash
2017 December 4;Barrow Boy  Barker;66.16;;GBP 50.00;; 1'472.56;restaurants
2017 December 4;St John;78.99;;GBP 60.00;; 1'538.72;restaurants
2017 December 4;The Hoxton Seven;70.79;;GBP 53.50;; 1'617.71;restaurants
2017 December 4;Le Cellier;17.80;;;; 1'688.50;restaurants
2017 December 4;Path? Rex;22.50;;;; 1'706.30;entertainment
2017 December 4;Path? Rex;90.00;;;; 1'728.80;entertainment
2017 December 4;Relay Nyon Cff;2.50;;;; 1'818.80;shopping
2017 December 2;To Charlotte Tengelin;5.95;;;; 1'821.30;transfers
2017 December 1;Restaurant Mekong;46.00;;;; 1'827.25;restaurants
2017 December 1;Green Gorilla;19.90;;;; 1'873.25;restaurants
2017 December 1;Migros Mmm Nyon La Com;48.55;;;; 1'893.15;groceries
2017 November 30;Grand Cafe Real Sa;58.30;;;; 1'941.70;restaurants
2017 November 30;Top-up via transfer;; 1'505.43;;; 2'000.00;general
2017 November 29;Migros Mmm Nyon La Com;42.45;;;; 494.57;groceries
2017 November 29;Kiosk Goodie Cornavin;6.90;;;; 537.02;restaurants
2017 November 28;No 1 Ski Rental;80.00;;;; 543.92;shopping
2017 November 27;Rest. Olympique  Cuck;15.70;;;; 623.92;restaurants
2017 November 27;Rest. Olympique  Cuck;9.00;;;; 639.62;restaurants
2017 November 27;T?l?verbier Sa;56.00;;;; 648.62;transport
2017 November 27;T?l?verbier Sa;56.00;;;; 704.62;transport
2017 November 27;Brasserie Le Bec;3.70;;;; 760.62;restaurants
2017 November 27;Brasserie Le Bec;85.20;;;; 764.32;restaurants
2017 November 27;Coop-1281 Verbier;2.55;;;; 849.52;groceries
2017 November 27;Green Gorilla;21.90;;;; 852.07;restaurants
2017 November 27;Schweiz. Bundesbahn;4.50;;;; 873.97;transport
2017 November 24;Pharmacie Principale *;43.80;;;; 878.47;health
2017 November 24;Bokus;25.74;;SEK 219.00;; 922.27;entertainment
2017 November 23;To Adrien De Castro;1.00;;;; 948.01;transfers
2017 November 23;To Matteo Vasirani;10.00;;;; 949.01;transfers
2017 November 23;Exchanged to GBP;76.74;;GBP  58.85;; 959.01;general
2017 November 23;Top-up via transfer;; 1'000.00;;; 1'035.75;general
2017 November 22;Migros M Fusterie;10.00;;;; 35.75;groceries
2017 November 21;To Charlotte Tengelin;1.00;;;; 45.75;transfers
2017 November 21;To Matteo Vasirani;1.00;;;; 46.75;transfers
2017 November 21;Exchanged from EUR;; 25.24;;EUR 21.68; 47.75;general
2017 November 20;Exchanged from EUR;; 20.00;;EUR 17.17; 22.51;general
2017 November 16;Exchanged to GBP;10.49;;GBP  7.99;; 2.51;general
2017 November 14;Extra Revolut Card;7.00;;;; 13.00;general
2017 November 9;Top-Up by *4748;; 20.00;;; 20.00;general
